county,administered_date,total_doses,cumulative_total_doses,pfizer_doses,moderna_doses,jj_doses,partially_vaccinated,total_partially_vaccinated,fully_vaccinated,cumulative_fully_vaccinated,at_least_one_dose
Alameda,12/15/2020,36,36,36,0,0,36,36,0,0,36
Alameda,12/16/2020,202,238,202,0,0,202,238,0,0,202
Alameda,12/17/2020,396,634,396,0,0,396,634,0,0,396
Alameda,12/18/2020,1766,2400,1765,1,0,1766,2400,0,0,1766
Alameda,12/19/2020,1357,3757,1357,0,0,1357,3757,0,0,1357
Alameda,12/20/2020,1156,4913,1155,1,0,1155,4911,1,1,1155
Alameda,12/21/2020,1859,6772,1858,1,0,1858,6769,0,1,1858
Alameda,12/22/2020,2099,8871,2047,52,0,2099,8868,0,1,2099
Alameda,12/23/2020,1927,10798,1671,256,0,1927,10795,0,1,1927
Alameda,12/24/2020,1218,12016,758,460,0,1218,12013,0,1,1218
Alameda,12/25/2020,165,12181,128,37,0,165,12178,0,1,165
Alameda,12/26/2020,867,13048,323,544,0,867,13045,0,1,867
Alameda,12/27/2020,500,13548,256,244,0,500,13545,0,1,500
Alameda,12/28/2020,1883,15431,957,926,0,1883,15428,0,1,1883
Alameda,12/29/2020,2427,17858,1022,1405,0,2426,17854,0,1,2426
Alameda,12/30/2020,3122,20980,1359,1763,0,3124,20978,0,1,3124
Alameda,12/31/2020,1789,22769,441,1348,0,1788,22765,1,2,1788
Alameda,1/1/2021,171,22940,70,101,0,170,22934,1,3,170
Alameda,1/2/2021,719,23659,521,198,0,718,23652,0,3,718
Alameda,1/3/2021,341,24000,220,121,0,338,23987,3,6,338
Alameda,1/4/2021,1647,25647,944,703,0,1635,25611,11,17,1635
Alameda,1/5/2021,2199,27846,1265,934,0,1963,27341,233,250,1963
Alameda,1/6/2021,3242,31088,1776,1466,0,2428,28960,811,1061,2430
Alameda,1/7/2021,3773,34861,2112,1661,0,2686,30572,1078,2139,2690
Alameda,1/8/2021,4724,39585,2695,2029,0,3103,32062,1617,3756,3107
Alameda,1/9/2021,2031,41616,1388,643,0,1170,32371,861,4617,1170
Alameda,1/10/2021,1061,42677,843,218,0,424,32157,638,5255,424
Alameda,1/11/2021,4630,47307,3502,1128,0,2842,33217,1788,7043,2848
Alameda,1/12/2021,4824,52131,3246,1578,0,3432,35261,1391,8434,3435
Alameda,1/13/2021,5025,57156,2654,2371,0,3846,37933,1175,9609,3847
Alameda,1/14/2021,5603,62759,2740,2863,0,4717,41776,877,10486,4720
Alameda,1/15/2021,5827,68586,2309,3518,0,5060,46079,760,11246,5063
Alameda,1/16/2021,3005,71591,1409,1596,0,2737,48549,268,11514,2738
Alameda,1/17/2021,1868,73459,1084,784,0,1661,50005,206,11720,1662
Alameda,1/18/2021,3192,76651,2049,1143,0,2598,52018,590,12310,2603
Alameda,1/19/2021,5516,82167,3329,2187,0,4329,55164,1185,13495,4331
Alameda,1/20/2021,6689,88856,4026,2663,0,5396,59283,1281,14776,5400
Alameda,1/21/2021,7739,96595,3382,4357,0,6911,65375,822,15598,6914
Alameda,1/22/2021,6837,103432,2032,4805,0,5699,69945,1131,16729,5701
Alameda,1/23/2021,3280,106712,943,2337,0,2728,72123,552,17281,2730
Alameda,1/24/2021,2049,108761,654,1395,0,1773,73624,272,17553,1773
Alameda,1/25/2021,5213,113974,1985,3228,0,3628,75675,1577,19130,3628
Alameda,1/26/2021,7241,121215,2286,4955,0,5382,79206,1852,20982,5383
Alameda,1/27/2021,6667,127882,2076,4591,0,4824,82198,1832,22814,4824
Alameda,1/28/2021,7868,135750,2541,5327,0,5631,85609,2221,25035,5632
Alameda,1/29/2021,7906,143656,3178,4728,0,6082,89878,1814,26849,6083
Alameda,1/30/2021,3411,147067,1666,1745,0,2710,91892,696,27545,2710
Alameda,1/31/2021,1902,148969,962,940,0,1659,93310,241,27786,1659
Alameda,2/1/2021,5953,154922,3351,2602,0,4317,95998,1630,29416,4318
Alameda,2/2/2021,7442,162364,4240,3202,0,4656,97878,2776,32192,4656
Alameda,2/3/2021,7077,169441,3728,3349,0,4406,99624,2665,34857,4411
Alameda,2/4/2021,9503,178944,4129,5374,0,6450,103043,3036,37893,6455
Alameda,2/5/2021,10320,189264,5386,4934,0,6454,105643,3860,41753,6460
Alameda,2/6/2021,6996,196260,4436,2560,0,5878,110403,1118,42871,5878
Alameda,2/7/2021,3581,199841,2892,689,0,2641,112108,937,43808,2642
Alameda,2/8/2021,8080,207921,5779,2301,0,5538,115116,2532,46340,5540
Alameda,2/9/2021,9701,217622,5852,3849,0,6052,117527,3643,49983,6054
Alameda,2/10/2021,11447,229069,6769,4678,0,6632,119369,4798,54781,6640
Alameda,2/11/2021,13912,242981,7972,5940,0,8372,122221,5523,60304,8375
Alameda,2/12/2021,12518,255499,5692,6826,0,7751,125222,4753,65057,7754
Alameda,2/13/2021,7804,263303,4063,3741,0,5845,129114,1955,67012,5847
Alameda,2/14/2021,4026,267329,2535,1491,0,2868,130829,1155,68167,2870
Alameda,2/15/2021,5705,273034,3220,2485,0,3697,132524,2005,70172,3700
Alameda,2/16/2021,12525,285559,6950,5575,0,9320,138654,3195,73367,9325
Alameda,2/17/2021,14098,299657,8351,5747,0,10483,145542,3597,76964,10485
Alameda,2/18/2021,15842,315499,10056,5786,0,11507,152723,4332,81296,11513
Alameda,2/19/2021,17628,333127,11427,6201,0,11686,158493,5920,87216,11690
Alameda,2/20/2021,11853,344980,9606,2247,0,9141,164930,2709,89925,9146
Alameda,2/21/2021,6185,351165,5255,930,0,3733,166220,2443,92368,3733
Alameda,2/22/2021,10688,361853,7912,2776,0,6739,169033,3936,96304,6749
Alameda,2/23/2021,12699,374552,7710,4989,0,7907,172164,4783,101087,7914
Alameda,2/24/2021,14646,389198,8202,6444,0,9499,176581,5087,106174,9504
Alameda,2/25/2021,15602,404800,9118,6484,0,9940,180897,5630,111804,9946
Alameda,2/26/2021,18075,422875,10627,7448,0,11694,186254,6341,118145,11698
Alameda,2/27/2021,14688,437563,10800,3886,2,9096,189784,5570,123715,9100
Alameda,2/28/2021,9139,446702,7705,1434,0,6071,192808,3048,126763,6072
Alameda,3/1/2021,13207,459909,9173,4032,2,8197,196044,4969,131732,8205
Alameda,3/2/2021,13789,473698,9578,4211,0,8866,200013,4904,136636,8873
Alameda,3/3/2021,15293,488991,9909,5383,1,10407,205562,4861,141497,10410
Alameda,3/4/2021,17262,506253,11026,6235,1,10864,210063,6364,147861,10865
Alameda,3/5/2021,15846,522099,10233,5604,9,10631,215534,5175,153036,10646
Alameda,3/6/2021,14212,536311,9946,4007,259,9337,220300,4832,157868,9598
Alameda,3/7/2021,9282,545593,8070,1131,81,6564,224254,2693,160561,6647
Alameda,3/8/2021,11609,557202,7151,4082,376,8647,230364,2912,163473,9022
Alameda,3/9/2021,11336,568538,6994,3913,429,6272,232034,5033,168506,6703
Alameda,3/10/2021,16647,585185,11310,4782,555,7539,231041,9084,177590,8091
Alameda,3/11/2021,19744,604929,11546,6492,1706,6757,226545,12958,190548,8462
Alameda,3/12/2021,21113,626042,12294,7169,1650,7454,222006,13637,204185,9098
Alameda,3/13/2021,15828,641870,10101,4749,978,5114,217412,10681,214866,6087
Alameda,3/14/2021,10687,652557,7806,2096,785,4663,216847,6008,220874,5443
Alameda,3/15/2021,14287,666844,9313,4457,517,6356,215814,7903,228777,6870
Alameda,3/16/2021,17133,683977,11085,5515,533,7548,214361,9535,238312,8082
Alameda,3/17/2021,17333,701310,9755,6886,692,8152,214057,9148,247460,8844
Alameda,3/18/2021,19024,720334,10308,7839,877,8756,213452,10241,257701,9636
Alameda,3/19/2021,19067,739401,10311,6968,1788,7632,211478,11388,269089,9414
Alameda,3/20/2021,15589,754990,10177,4594,818,6525,209782,9037,278126,7341
Alameda,3/21/2021,9043,764033,7091,1421,531,3766,208812,5268,283394,4298
Alameda,3/22/2021,14857,778890,9986,3892,979,7174,209296,7666,291060,8150
Alameda,3/23/2021,19042,797932,11478,6771,793,10699,212490,8303,299363,11497
Alameda,3/24/2021,18930,816862,11382,6558,990,8584,211766,10291,309654,9567
Alameda,3/25/2021,20308,837170,11199,7732,1377,9553,211995,10692,320346,10921
Alameda,3/26/2021,20614,857784,12348,6738,1528,8833,210611,11737,332083,10353
Alameda,3/27/2021,18120,875904,12301,4864,955,7812,209099,10262,342345,8750
Alameda,3/28/2021,10416,886320,8432,1781,203,3831,206564,6575,348920,4040
Alameda,3/29/2021,14549,900869,9264,4291,994,6254,205550,8262,357182,7248
Alameda,3/30/2021,18383,919252,9652,7042,1689,10791,210464,7564,364746,12478
Alameda,3/31/2021,19168,938420,10087,7028,2053,9569,212485,9576,374322,11597
Alameda,4/1/2021,22926,961346,9924,7533,5469,10936,216920,11965,386287,16400
Alameda,4/2/2021,23667,985013,9795,8202,5670,11464,221867,12174,398461,17121
Alameda,4/3/2021,20026,1005039,9699,5641,4686,10240,227024,9771,408232,14928
Alameda,4/4/2021,9897,1014936,3948,2276,3673,3504,227812,6384,414616,7172
Alameda,4/5/2021,17642,1032578,7387,5497,4758,7160,229264,10465,425081,11917
Alameda,4/6/2021,21980,1054558,10552,5639,5789,9976,233051,11974,437055,15761
Alameda,4/7/2021,22325,1076883,11431,5471,5423,11310,238807,10974,448029,16730
Alameda,4/8/2021,25222,1102105,11424,5888,7910,10757,243075,14399,462428,18667
Alameda,4/9/2021,23000,1125105,10396,7431,5173,11830,248940,11147,473575,17012
Alameda,4/10/2021,18742,1143847,7370,5566,5806,8125,252265,10599,484174,13924
Alameda,4/11/2021,10957,1154804,4764,2261,3932,4478,254204,6464,490638,8403
Alameda,4/12/2021,17615,1172419,11587,4223,1805,9998,258415,7589,498227,11800
Alameda,4/13/2021,22880,1195299,14614,8213,53,16929,269499,5907,504134,16991
Alameda,4/14/2021,22841,1218140,15159,7681,1,15566,277826,7245,511379,15572
Alameda,4/15/2021,23501,1241641,15133,8366,2,15620,285621,7835,519214,15630
Alameda,4/16/2021,24005,1265646,14230,9771,4,15528,292736,8426,527640,15541
Alameda,4/17/2021,20500,1286146,14134,6366,0,14166,300610,6306,533946,14180
Alameda,4/18/2021,9801,1295947,7466,2335,0,6785,304409,2990,536936,6789
Alameda,4/19/2021,14951,1310898,9229,5722,0,8521,306534,6405,543341,8530
Alameda,4/20/2021,17669,1328567,10667,7000,2,9584,308093,8046,551387,9605
Alameda,4/21/2021,18143,1346710,10538,7599,6,10352,310731,7739,559126,10377
Alameda,4/22/2021,17212,1363922,10686,6523,3,9038,311648,8141,567267,9058
Alameda,4/23/2021,12379,1376301,8029,4349,1,7269,313839,5083,572350,7274
Alpine,12/18/2020,2,2,2,0,0,2,2,0,0,2
Alpine,12/19/2020,2,4,2,0,0,2,4,0,0,2
Alpine,12/21/2020,2,6,2,0,0,2,6,0,0,2
Alpine,12/30/2020,14,20,0,14,0,14,20,0,0,14
Alpine,12/31/2020,1,21,0,1,0,1,21,0,0,1
Alpine,1/1/2021,1,22,0,1,0,1,22,0,0,1
Alpine,1/2/2021,1,23,1,0,0,1,23,0,0,1
Alpine,1/4/2021,10,33,0,10,0,10,33,0,0,10
Alpine,1/5/2021,9,42,1,8,0,9,42,0,0,9
Alpine,1/6/2021,31,73,0,31,0,31,73,0,0,31
Alpine,1/7/2021,8,81,0,8,0,8,81,0,0,8
Alpine,1/8/2021,4,85,2,2,0,2,81,2,2,2
Alpine,1/9/2021,2,87,2,0,0,0,79,2,4,0
Alpine,1/11/2021,32,119,1,31,0,31,109,1,5,31
Alpine,1/13/2021,35,154,0,35,0,35,144,0,5,35
Alpine,1/14/2021,1,155,0,1,0,1,145,0,5,1
Alpine,1/15/2021,1,156,0,1,0,1,146,0,5,1
Alpine,1/20/2021,21,177,0,21,0,21,167,0,5,21
Alpine,1/21/2021,1,178,0,1,0,1,168,0,5,1
Alpine,1/22/2021,32,210,0,32,0,32,200,0,5,32
Alpine,1/23/2021,1,211,1,0,0,0,199,1,6,0
Alpine,1/25/2021,16,227,0,16,0,16,215,0,6,16
Alpine,1/27/2021,1,228,1,0,0,0,214,1,7,0
Alpine,1/28/2021,1,229,0,1,0,0,213,1,8,0
Alpine,1/29/2021,1,230,0,1,0,1,214,0,8,1
Alpine,2/1/2021,25,255,0,25,0,7,203,18,26,7
Alpine,2/3/2021,34,289,0,34,0,10,189,24,50,10
Alpine,2/4/2021,8,297,0,8,0,3,187,5,55,3
Alpine,2/5/2021,31,328,0,31,0,12,180,19,74,12
Alpine,2/6/2021,1,329,1,0,0,1,181,0,74,1
Alpine,2/7/2021,1,330,1,0,0,1,182,0,74,1
Alpine,2/8/2021,32,362,0,32,0,4,158,28,102,4
Alpine,2/10/2021,34,396,0,34,0,0,124,34,136,0
Alpine,2/11/2021,6,402,0,6,0,3,124,3,139,3
Alpine,2/12/2021,1,403,0,1,0,0,123,1,140,0
Alpine,2/17/2021,23,426,0,23,0,3,106,20,160,3
Alpine,2/18/2021,2,428,0,2,0,1,106,1,161,1
Alpine,2/19/2021,34,462,1,33,0,2,76,32,193,2
Alpine,2/22/2021,27,489,0,27,0,8,65,19,212,8
Alpine,2/24/2021,1,490,1,0,0,1,66,0,212,1
Alpine,2/25/2021,6,496,1,5,0,6,72,0,212,6
Alpine,2/26/2021,29,525,1,28,0,28,99,1,213,28
Alpine,2/27/2021,1,526,0,1,0,1,100,0,213,1
Alpine,3/1/2021,35,561,0,35,0,25,115,10,223,25
Alpine,3/2/2021,1,562,1,0,0,0,114,1,224,0
Alpine,3/3/2021,30,592,1,29,0,18,120,12,236,18
Alpine,3/4/2021,11,603,1,10,0,11,131,0,236,11
Alpine,3/5/2021,30,633,0,30,0,22,145,8,244,22
Alpine,3/8/2021,31,664,0,31,0,29,172,2,246,29
Alpine,3/10/2021,72,736,0,72,0,72,244,0,246,72
Alpine,3/11/2021,36,772,0,36,0,32,272,4,250,32
Alpine,3/12/2021,19,791,0,19,0,17,287,2,252,17
Alpine,3/15/2021,21,812,1,20,0,20,306,1,253,20
Alpine,3/17/2021,23,835,0,22,1,19,322,4,257,20
Alpine,3/18/2021,38,873,3,35,0,35,354,3,260,35
Alpine,3/19/2021,2,875,1,1,0,1,354,1,261,1
Alpine,3/22/2021,24,899,0,24,0,15,360,9,270,15
Alpine,3/24/2021,19,918,0,19,0,9,359,10,280,9
Alpine,3/25/2021,35,953,1,33,1,28,381,7,287,29
Alpine,3/27/2021,1,954,0,1,0,0,380,1,288,0
Alpine,3/28/2021,1,955,1,0,0,1,381,0,288,1
Alpine,3/29/2021,20,975,0,19,1,3,368,17,305,4
Alpine,4/1/2021,16,991,0,16,0,7,366,9,314,7
Alpine,4/2/2021,100,1091,1,99,0,46,359,53,367,46
Alpine,4/5/2021,4,1095,1,3,0,0,355,4,371,0
Alpine,4/6/2021,3,1098,2,1,0,2,356,1,372,2
Alpine,4/7/2021,115,1213,0,114,1,29,301,85,457,30
Alpine,4/8/2021,38,1251,0,36,2,10,285,28,485,12
Alpine,4/9/2021,1,1252,0,1,0,1,286,0,485,1
Alpine,4/14/2021,47,1299,0,47,0,10,259,37,522,10
Alpine,4/15/2021,35,1334,0,35,0,3,230,32,554,3
Alpine,4/16/2021,1,1335,0,1,0,1,231,0,554,1
Alpine,4/19/2021,1,1336,0,1,0,1,232,0,554,1
Alpine,4/21/2021,31,1367,0,31,0,15,231,16,570,15
Alpine,4/22/2021,24,1391,0,24,0,1,209,23,593,1
Amador,12/16/2020,2,2,2,0,0,2,2,0,0,2
Amador,12/17/2020,5,7,5,0,0,5,7,0,0,5
Amador,12/18/2020,45,52,45,0,0,45,52,0,0,45
Amador,12/19/2020,17,69,17,0,0,17,69,0,0,17
Amador,12/20/2020,4,73,4,0,0,4,73,0,0,4
Amador,12/21/2020,32,105,32,0,0,32,105,0,0,32
Amador,12/22/2020,35,140,34,1,0,35,140,0,0,35
Amador,12/23/2020,39,179,38,1,0,39,179,0,0,39
Amador,12/24/2020,5,184,3,2,0,5,184,0,0,5
Amador,12/26/2020,5,189,4,1,0,5,189,0,0,5
Amador,12/27/2020,1,190,0,1,0,1,190,0,0,1
Amador,12/28/2020,31,221,27,4,0,31,221,0,0,31
Amador,12/29/2020,26,247,19,7,0,26,247,0,0,26
Amador,12/30/2020,124,371,78,46,0,124,371,0,0,124
Amador,12/31/2020,192,563,167,25,0,192,563,0,0,192
Amador,1/1/2021,1,564,0,1,0,1,564,0,0,1
Amador,1/2/2021,55,619,55,0,0,55,619,0,0,55
Amador,1/3/2021,65,684,17,48,0,65,684,0,0,65
Amador,1/4/2021,123,807,1,122,0,123,807,0,0,123
Amador,1/5/2021,33,840,3,30,0,31,837,2,2,32
Amador,1/6/2021,40,880,10,30,0,36,869,4,6,36
Amador,1/7/2021,227,1107,68,159,0,215,1072,12,18,215
Amador,1/8/2021,84,1191,70,14,0,40,1069,44,62,41
Amador,1/9/2021,11,1202,11,0,0,2,1062,9,71,2
Amador,1/10/2021,7,1209,5,2,0,3,1061,4,75,3
Amador,1/11/2021,125,1334,45,80,0,89,1114,36,111,89
Amador,1/12/2021,64,1398,49,15,0,40,1130,24,135,40
Amador,1/13/2021,38,1436,23,15,0,26,1144,12,147,26
Amador,1/14/2021,146,1582,20,126,0,136,1270,10,157,136
Amador,1/15/2021,55,1637,24,31,0,48,1311,7,164,48
Amador,1/16/2021,19,1656,12,7,0,13,1319,6,170,14
Amador,1/17/2021,25,1681,5,20,0,25,1344,0,170,25
Amador,1/18/2021,31,1712,27,4,0,9,1331,22,192,9
Amador,1/19/2021,119,1831,96,23,0,75,1362,44,236,75
Amador,1/20/2021,183,2014,34,149,0,167,1514,15,251,167
Amador,1/21/2021,252,2266,221,31,0,144,1551,108,359,145
Amador,1/22/2021,133,2399,72,61,0,126,1670,7,366,126
Amador,1/23/2021,52,2451,32,20,0,50,1718,2,368,50
Amador,1/24/2021,28,2479,12,16,0,25,1740,3,371,25
Amador,1/25/2021,59,2538,28,31,0,42,1765,17,388,42
Amador,1/26/2021,244,2782,16,228,0,234,1989,10,398,234
Amador,1/27/2021,296,3078,30,266,0,249,2194,45,443,250
Amador,1/28/2021,345,3423,76,269,0,284,2418,61,504,285
Amador,1/29/2021,95,3518,30,65,0,80,2483,15,519,80
Amador,1/30/2021,167,3685,33,134,0,162,2640,5,524,162
Amador,1/31/2021,32,3717,28,4,0,31,2670,1,525,31
Amador,2/1/2021,63,3780,23,40,0,36,2679,27,552,36
Amador,2/2/2021,213,3993,65,148,0,127,2723,83,635,127
Amador,2/3/2021,141,4134,38,103,0,90,2763,50,685,90
Amador,2/4/2021,248,4382,72,176,0,163,2843,85,770,165
Amador,2/5/2021,331,4713,63,268,0,315,3142,16,786,315
Amador,2/6/2021,99,4812,80,19,0,95,3233,4,790,95
Amador,2/7/2021,38,4850,35,3,0,35,3265,3,793,35
Amador,2/8/2021,90,4940,62,28,0,73,3321,17,810,73
Amador,2/9/2021,173,5113,83,90,0,108,3364,65,875,108
Amador,2/10/2021,976,6089,77,899,0,943,4274,33,908,943
Amador,2/11/2021,305,6394,118,187,0,200,4370,104,1012,200
Amador,2/12/2021,324,6718,118,206,0,253,4552,71,1083,253
Amador,2/13/2021,165,6883,81,84,0,139,4665,26,1109,139
Amador,2/14/2021,123,7006,54,69,0,106,4754,17,1126,106
Amador,2/15/2021,186,7192,60,126,0,169,4907,16,1142,169
Amador,2/16/2021,462,7654,53,409,0,425,5296,37,1179,426
Amador,2/17/2021,258,7912,80,178,0,163,5364,95,1274,163
Amador,2/18/2021,397,8309,98,299,0,335,5638,62,1336,336
Amador,2/19/2021,192,8501,76,116,0,111,5668,81,1417,111
Amador,2/20/2021,91,8592,29,62,0,64,5705,27,1444,64
Amador,2/21/2021,45,8637,34,11,0,15,5690,30,1474,15
Amador,2/22/2021,63,8700,24,39,0,32,5692,30,1504,32
Amador,2/23/2021,318,9018,55,263,0,138,5651,180,1684,139
Amador,2/24/2021,392,9410,56,336,0,262,5787,126,1810,262
Amador,2/25/2021,517,9927,113,404,0,278,5827,238,2048,278
Amador,2/26/2021,608,10535,75,533,0,503,6226,105,2153,504
Amador,2/27/2021,288,10823,91,197,0,100,6141,187,2340,102
Amador,2/28/2021,101,10924,52,49,0,55,6153,46,2386,58
Amador,3/1/2021,188,11112,66,122,0,119,6204,69,2455,120
Amador,3/2/2021,379,11491,62,317,0,329,6484,50,2505,330
Amador,3/3/2021,240,11731,78,162,0,165,6576,74,2579,166
Amador,3/4/2021,494,12225,116,378,0,392,6866,102,2681,392
Amador,3/5/2021,512,12737,77,435,0,294,6945,217,2898,296
Amador,3/6/2021,99,12836,45,53,1,54,6955,45,2943,55
Amador,3/7/2021,63,12899,42,21,0,20,6932,43,2986,20
Amador,3/8/2021,152,13051,71,80,1,91,6963,61,3047,92
Amador,3/9/2021,367,13418,47,320,0,291,7181,73,3120,291
Amador,3/10/2021,506,13924,73,431,2,109,6896,397,3517,112
Amador,3/11/2021,468,14392,113,344,11,297,7037,170,3687,311
Amador,3/12/2021,567,14959,65,494,8,337,7158,229,3916,350
Amador,3/13/2021,114,15073,18,89,7,75,7205,39,3955,86
Amador,3/14/2021,89,15162,19,67,3,21,7161,68,4023,24
Amador,3/15/2021,177,15339,25,145,7,53,7099,124,4147,62
Amador,3/16/2021,448,15787,55,383,10,137,6937,309,4456,147
Amador,3/17/2021,190,15977,41,146,3,114,6979,76,4532,118
Amador,3/18/2021,471,16448,97,370,4,247,7009,224,4756,254
Amador,3/19/2021,540,16988,56,467,17,391,7273,147,4903,411
Amador,3/20/2021,110,17098,46,63,1,47,7261,62,4965,50
Amador,3/21/2021,48,17146,36,11,1,31,7279,16,4981,34
Amador,3/22/2021,114,17260,33,52,29,50,7294,64,5045,79
Amador,3/23/2021,432,17692,48,376,8,276,7423,155,5200,284
Amador,3/24/2021,341,18033,35,55,251,36,7406,304,5504,287
Amador,3/25/2021,598,18631,81,511,6,388,7591,209,5713,394
Amador,3/26/2021,738,19369,43,689,6,282,7429,453,6166,291
Amador,3/27/2021,90,19459,14,74,2,26,7395,64,6230,30
Amador,3/28/2021,68,19527,15,51,2,14,7359,53,6283,17
Amador,3/29/2021,179,19706,26,152,1,81,7350,96,6379,87
Amador,3/30/2021,532,20238,28,503,1,298,7416,233,6612,299
Amador,3/31/2021,202,20440,57,140,5,47,7313,155,6767,52
Amador,4/1/2021,613,21053,85,528,0,266,7236,345,7112,268
Amador,4/2/2021,603,21656,34,557,12,383,7414,218,7330,396
Amador,4/3/2021,83,21739,20,43,20,20,7392,63,7393,41
Amador,4/4/2021,39,21778,4,29,6,16,7391,23,7416,22
Amador,4/5/2021,140,21918,48,74,18,45,7361,94,7510,64
Amador,4/6/2021,501,22419,37,445,19,223,7327,276,7786,242
Amador,4/7/2021,100,22519,34,47,19,44,7336,54,7840,63
Amador,4/8/2021,497,23016,84,391,22,223,7308,273,8113,245
Amador,4/9/2021,482,23498,21,442,19,214,7272,267,8380,231
Amador,4/10/2021,51,23549,14,26,11,22,7276,29,8409,33
Amador,4/11/2021,48,23597,23,21,4,22,7276,26,8435,26
Amador,4/12/2021,98,23695,27,62,9,43,7273,55,8490,52
Amador,4/13/2021,343,24038,49,294,0,68,7067,274,8764,68
Amador,4/14/2021,276,24314,25,251,0,177,7146,98,8862,177
Amador,4/15/2021,329,24643,74,255,0,73,6969,250,9112,73
Amador,4/16/2021,483,25126,29,454,0,384,7256,97,9209,384
Amador,4/17/2021,63,25189,37,26,0,27,7247,36,9245,27
Amador,4/18/2021,25,25214,5,20,0,11,7244,14,9259,11
Amador,4/19/2021,69,25283,27,42,0,31,7240,37,9296,33
Amador,4/20/2021,434,25717,53,381,0,111,7036,317,9613,113
Amador,4/21/2021,86,25803,33,53,0,43,7037,42,9655,43
Amador,4/22/2021,143,25946,66,76,1,61,7021,78,9733,62
Amador,4/23/2021,285,26231,6,279,0,228,7194,56,9789,229
Butte,12/16/2020,3,3,3,0,0,3,3,0,0,3
Butte,12/17/2020,21,24,21,0,0,21,24,0,0,21
Butte,12/18/2020,50,74,50,0,0,50,74,0,0,50
Butte,12/19/2020,7,81,7,0,0,7,81,0,0,7
Butte,12/20/2020,10,91,10,0,0,10,91,0,0,10
Butte,12/21/2020,634,725,634,0,0,634,725,0,0,634
Butte,12/22/2020,618,1343,616,2,0,618,1343,0,0,618
Butte,12/23/2020,869,2212,853,16,0,869,2212,0,0,869
Butte,12/24/2020,159,2371,156,3,0,159,2371,0,0,159
Butte,12/26/2020,93,2464,91,2,0,93,2464,0,0,93
Butte,12/27/2020,35,2499,34,1,0,35,2499,0,0,35
Butte,12/28/2020,279,2778,273,6,0,279,2778,0,0,279
Butte,12/29/2020,204,2982,180,24,0,204,2982,0,0,204
Butte,12/30/2020,502,3484,291,211,0,502,3484,0,0,502
Butte,12/31/2020,211,3695,18,193,0,211,3695,0,0,211
Butte,1/1/2021,8,3703,1,7,0,8,3703,0,0,8
Butte,1/2/2021,41,3744,38,3,0,41,3744,0,0,41
Butte,1/3/2021,4,3748,1,3,0,4,3748,0,0,4
Butte,1/4/2021,209,3957,175,34,0,209,3957,0,0,209
Butte,1/5/2021,196,4153,151,45,0,195,4151,1,1,195
Butte,1/6/2021,623,4776,397,226,0,618,4765,5,6,619
Butte,1/7/2021,763,5539,371,392,0,743,5488,20,26,743
Butte,1/8/2021,572,6111,529,43,0,526,5968,46,72,526
Butte,1/9/2021,12,6123,7,5,0,7,5970,5,77,7
Butte,1/10/2021,19,6142,5,14,0,14,5979,5,82,14
Butte,1/11/2021,986,7128,950,36,0,357,5710,629,711,360
Butte,1/12/2021,697,7825,652,45,0,274,5561,423,1134,274
Butte,1/13/2021,1448,9273,954,494,0,614,5343,834,1968,616
Butte,1/14/2021,1637,10910,896,741,0,1440,6587,196,2164,1440
Butte,1/15/2021,1170,12080,926,244,0,1061,7538,110,2274,1061
Butte,1/16/2021,586,12666,300,286,0,541,8034,45,2319,541
Butte,1/17/2021,239,12905,64,175,0,202,8199,37,2356,202
Butte,1/18/2021,342,13247,302,40,0,274,8406,67,2423,274
Butte,1/19/2021,493,13740,429,64,0,220,8353,273,2696,220
Butte,1/20/2021,1346,15086,665,681,0,1043,9093,303,2999,1043
Butte,1/21/2021,1474,16560,866,608,0,1366,10352,107,3106,1366
Butte,1/22/2021,995,17555,336,659,0,942,11241,53,3159,942
Butte,1/23/2021,125,17680,83,42,0,99,11314,26,3185,99
Butte,1/24/2021,9,17689,7,2,0,9,11323,0,3185,9
Butte,1/25/2021,654,18343,336,318,0,491,11651,163,3348,491
Butte,1/26/2021,1467,19810,377,1090,0,1330,12844,137,3485,1330
Butte,1/27/2021,2083,21893,708,1375,0,1364,13490,718,4203,1364
Butte,1/28/2021,2262,24155,261,2001,0,1951,15131,310,4513,1951
Butte,1/29/2021,1677,25832,488,1189,0,1298,16051,378,4891,1298
Butte,1/30/2021,32,25864,9,23,0,29,16077,3,4894,29
Butte,1/31/2021,17,25881,15,2,0,16,16092,1,4895,16
Butte,2/1/2021,1748,27629,406,1342,0,1359,17064,387,5282,1359
Butte,2/2/2021,1931,29560,362,1569,0,1628,18388,304,5586,1628
Butte,2/3/2021,2733,32293,772,1961,0,1843,19343,888,6474,1843
Butte,2/4/2021,2960,35253,327,2633,0,2405,21195,553,7027,2405
Butte,2/5/2021,1168,36421,662,506,0,537,21102,631,7658,538
Butte,2/6/2021,143,36564,102,41,0,61,21081,82,7740,61
Butte,2/7/2021,37,36601,33,4,0,13,21070,24,7764,13
Butte,2/8/2021,689,37290,540,149,0,238,20857,451,8215,238
Butte,2/9/2021,951,38241,457,494,0,724,21354,227,8442,724
Butte,2/10/2021,1708,39949,1191,517,0,699,21046,1007,9449,699
Butte,2/11/2021,2198,42147,1348,850,0,1004,20856,1194,10643,1004
Butte,2/12/2021,867,43014,302,565,0,317,20624,549,11192,317
Butte,2/13/2021,254,43268,45,209,0,151,20672,103,11295,151
Butte,2/14/2021,160,43428,9,151,0,155,20822,5,11300,155
Butte,2/15/2021,261,43689,48,213,0,198,20957,63,11363,198
Butte,2/16/2021,729,44418,428,301,0,273,20773,457,11820,273
Butte,2/17/2021,1513,45931,847,666,0,841,20944,670,12490,841
Butte,2/18/2021,1549,47480,758,791,0,744,20883,805,13295,744
Butte,2/19/2021,1166,48646,387,779,0,401,20526,758,14053,401
Butte,2/20/2021,473,49119,28,445,0,120,20294,352,14405,120
Butte,2/21/2021,15,49134,13,2,0,11,20301,4,14409,11
Butte,2/22/2021,1492,50626,295,1197,0,381,19572,1110,15519,381
Butte,2/23/2021,1633,52259,298,1335,0,463,18870,1165,16684,463
Butte,2/24/2021,2132,54391,596,1536,0,729,18204,1395,18079,729
Butte,2/25/2021,2073,56464,574,1499,0,652,17441,1416,19495,653
Butte,2/26/2021,921,57385,311,610,0,398,17319,520,20015,398
Butte,2/27/2021,233,57618,47,186,0,186,17460,45,20060,186
Butte,2/28/2021,139,57757,16,123,0,131,17583,8,20068,131
Butte,3/1/2021,1623,59380,178,1444,1,327,16616,1295,21363,328
Butte,3/2/2021,1737,61117,192,1545,0,305,15493,1428,22791,305
Butte,3/3/2021,2779,63896,844,1935,0,481,13677,2297,25088,481
Butte,3/4/2021,3122,67018,659,2463,0,610,11776,2511,27599,610
Butte,3/5/2021,1328,68346,604,723,1,722,11896,603,28202,723
Butte,3/6/2021,244,68590,27,194,23,183,12042,60,28262,206
Butte,3/7/2021,55,68645,3,35,17,30,12064,25,28287,47
Butte,3/8/2021,1262,69907,128,1057,77,1098,13077,162,28449,1175
Butte,3/9/2021,1896,71803,276,1517,103,1411,14107,484,28933,1514
Butte,3/10/2021,2321,74124,966,1255,100,1582,15054,734,29667,1681
Butte,3/11/2021,2800,76924,1313,1362,125,1977,16343,813,30480,2102
Butte,3/12/2021,1136,78060,324,466,346,354,16267,776,31256,700
Butte,3/13/2021,252,78312,68,136,48,64,16191,188,31444,112
Butte,3/14/2021,160,78472,15,103,42,21,16116,138,31582,63
Butte,3/15/2021,1719,80191,360,1066,293,1126,16947,588,32170,1419
Butte,3/16/2021,1623,81814,414,1131,78,1083,17570,537,32707,1160
Butte,3/17/2021,1950,83764,1357,512,81,1131,17970,811,33518,1211
Butte,3/18/2021,1797,85561,1455,213,129,1058,18421,735,34253,1186
Butte,3/19/2021,697,86258,313,300,84,345,18505,345,34598,429
Butte,3/20/2021,205,86463,32,157,16,93,18502,112,34710,109
Butte,3/21/2021,57,86520,26,2,29,15,18504,42,34752,44
Butte,3/22/2021,1461,87981,353,1014,94,1197,19533,262,35014,1291
Butte,3/23/2021,1795,89776,487,1194,114,1451,20755,343,35357,1565
Butte,3/24/2021,2246,92022,1263,857,126,1700,22038,542,35899,1825
Butte,3/25/2021,1481,93503,1199,192,90,1019,22688,459,36358,1109
Butte,3/26/2021,1201,94704,434,521,246,561,22863,632,36990,807
Butte,3/27/2021,300,95004,83,193,24,132,22853,165,37155,155
Butte,3/28/2021,224,95228,42,174,8,100,22839,121,37276,107
Butte,3/29/2021,1720,96948,381,1269,70,1309,23810,408,37684,1379
Butte,3/30/2021,1032,97980,466,476,90,492,23858,534,38218,582
Butte,3/31/2021,1776,99756,1304,405,67,1086,24327,684,38902,1153
Butte,4/1/2021,3282,103038,2665,490,127,2214,25606,1063,39965,2342
Butte,4/2/2021,992,104030,414,459,119,560,25860,424,40389,678
Butte,4/3/2021,345,104375,47,223,75,166,25922,179,40568,241
Butte,4/4/2021,185,104560,22,140,23,107,25976,76,40644,130
Butte,4/5/2021,1958,106518,419,1369,170,601,25396,1350,41994,770
Butte,4/6/2021,2182,108700,617,1145,420,785,25208,1391,43385,1203
Butte,4/7/2021,2996,111696,1310,1295,391,687,23982,2304,45689,1078
Butte,4/8/2021,2714,114410,1185,1263,266,436,22409,2275,47964,702
Butte,4/9/2021,1365,115775,346,540,479,327,22179,1035,48999,805
Butte,4/10/2021,217,115992,46,74,97,95,22249,121,49120,191
Butte,4/11/2021,101,116093,44,47,10,81,22322,18,49138,91
Butte,4/12/2021,1406,117499,316,956,134,252,21554,1154,50292,386
Butte,4/13/2021,1636,119135,571,1059,6,351,20634,1278,51570,358
Butte,4/14/2021,2827,121962,2337,490,0,1315,20443,1507,53077,1316
Butte,4/15/2021,610,122572,373,237,0,462,20759,146,53223,462
Butte,4/16/2021,799,123371,406,393,0,474,20911,322,53545,474
Butte,4/17/2021,334,123705,60,274,0,234,21046,99,53644,234
Butte,4/18/2021,38,123743,8,30,0,34,21076,4,53648,34
Butte,4/19/2021,1556,125299,381,1175,0,447,20417,1106,54754,447
Butte,4/20/2021,1971,127270,726,1245,0,790,20031,1176,55930,790
Butte,4/21/2021,2045,129315,1167,878,0,479,18950,1560,57490,479
Butte,4/22/2021,2100,131415,1833,267,0,537,17927,1560,59050,537
Butte,4/23/2021,640,132055,334,306,0,343,17975,295,59345,343
Calaveras,12/16/2020,5,5,5,0,0,5,5,0,0,5
Calaveras,12/17/2020,3,8,3,0,0,3,8,0,0,3
Calaveras,12/18/2020,38,46,38,0,0,38,46,0,0,38
Calaveras,12/19/2020,3,49,3,0,0,3,49,0,0,3
Calaveras,12/20/2020,3,52,3,0,0,3,52,0,0,3
Calaveras,12/21/2020,55,107,48,7,0,55,107,0,0,55
Calaveras,12/22/2020,80,187,76,4,0,81,188,0,0,81
Calaveras,12/23/2020,76,263,74,2,0,76,264,0,0,76
Calaveras,12/24/2020,2,265,2,0,0,2,266,0,0,2
Calaveras,12/26/2020,3,268,3,0,0,3,269,0,0,3
Calaveras,12/28/2020,22,290,18,4,0,21,289,1,1,21
Calaveras,12/29/2020,168,458,148,20,0,168,457,0,1,168
Calaveras,12/30/2020,94,552,82,12,0,94,551,0,1,94
Calaveras,12/31/2020,35,587,25,10,0,35,586,0,1,35
Calaveras,1/2/2021,11,598,11,0,0,11,597,0,1,11
Calaveras,1/3/2021,9,607,4,5,0,9,606,0,1,9
Calaveras,1/4/2021,33,640,5,28,0,33,639,0,1,33
Calaveras,1/5/2021,41,681,10,31,0,33,669,8,9,38
Calaveras,1/6/2021,107,788,29,78,0,97,756,10,19,97
Calaveras,1/7/2021,104,892,25,79,0,92,838,11,30,93
Calaveras,1/8/2021,68,960,38,30,0,45,861,23,53,46
Calaveras,1/9/2021,5,965,5,0,0,2,860,3,56,2
Calaveras,1/10/2021,2,967,0,2,0,2,862,0,56,2
Calaveras,1/11/2021,64,1031,58,6,0,27,854,36,92,28
Calaveras,1/12/2021,85,1116,52,33,0,52,874,33,125,53
Calaveras,1/13/2021,107,1223,43,64,0,74,916,33,158,75
Calaveras,1/14/2021,135,1358,40,95,0,102,987,32,190,103
Calaveras,1/15/2021,90,1448,28,62,0,71,1039,19,209,71
Calaveras,1/16/2021,13,1461,2,11,0,12,1050,1,210,12
Calaveras,1/17/2021,10,1471,1,9,0,10,1060,0,210,10
Calaveras,1/18/2021,131,1602,19,112,0,118,1168,13,223,121
Calaveras,1/19/2021,204,1806,174,30,0,62,1090,141,364,63
Calaveras,1/20/2021,375,2181,81,294,0,291,1306,83,447,299
Calaveras,1/21/2021,461,2642,40,421,0,434,1719,27,474,440
Calaveras,1/22/2021,400,3042,23,377,0,390,2106,10,484,397
Calaveras,1/23/2021,22,3064,10,12,0,18,2120,4,488,18
Calaveras,1/24/2021,13,3077,8,5,0,11,2129,2,490,11
Calaveras,1/25/2021,84,3161,8,76,0,79,2203,5,495,79
Calaveras,1/26/2021,47,3208,16,31,0,38,2232,9,504,38
Calaveras,1/27/2021,133,3341,43,90,0,106,2312,26,530,106
Calaveras,1/28/2021,163,3504,22,141,0,140,2432,23,553,143
Calaveras,1/29/2021,386,3890,13,373,0,362,2778,24,577,370
Calaveras,1/30/2021,27,3917,10,17,0,25,2803,0,577,25
Calaveras,1/31/2021,5,3922,3,2,0,4,2806,1,578,4
Calaveras,2/1/2021,24,3946,11,13,0,18,2818,6,584,18
Calaveras,2/2/2021,108,4054,22,86,0,70,2855,34,618,71
Calaveras,2/3/2021,430,4484,43,387,0,347,3121,82,700,348
Calaveras,2/4/2021,377,4861,24,353,0,295,3334,82,782,295
Calaveras,2/5/2021,79,4940,23,56,0,41,3338,38,820,42
Calaveras,2/6/2021,22,4962,13,9,0,22,3360,0,820,22
Calaveras,2/7/2021,4,4966,1,3,0,2,3360,2,822,2
Calaveras,2/8/2021,38,5004,17,21,0,30,3384,6,828,30
Calaveras,2/9/2021,189,5193,74,115,0,128,3457,55,883,128
Calaveras,2/10/2021,508,5701,27,481,0,443,3836,65,948,444
Calaveras,2/11/2021,579,6280,78,501,0,473,4207,103,1051,474
Calaveras,2/12/2021,569,6849,325,244,0,494,4629,73,1124,495
Calaveras,2/13/2021,193,7042,37,156,0,178,4792,15,1139,178
Calaveras,2/14/2021,221,7263,71,150,0,206,4983,15,1154,206
Calaveras,2/15/2021,381,7644,22,359,0,261,5127,117,1271,261
Calaveras,2/16/2021,268,7912,143,125,0,232,5323,36,1307,232
Calaveras,2/17/2021,509,8421,37,472,0,211,5244,291,1598,212
Calaveras,2/18/2021,497,8918,90,407,0,98,4953,389,1987,98
Calaveras,2/19/2021,436,9354,43,393,0,97,4721,329,2316,97
Calaveras,2/20/2021,59,9413,15,44,0,48,4758,11,2327,48
Calaveras,2/21/2021,22,9435,13,9,0,19,4774,3,2330,19
Calaveras,2/22/2021,61,9496,38,23,0,33,4779,28,2358,33
Calaveras,2/23/2021,121,9617,39,82,0,87,4833,34,2392,88
Calaveras,2/24/2021,97,9714,48,49,0,66,4869,30,2422,66
Calaveras,2/25/2021,549,10263,98,451,0,360,5043,186,2608,360
Calaveras,2/26/2021,706,10969,47,659,0,370,5094,321,2929,372
Calaveras,2/27/2021,201,11170,21,180,0,178,5249,23,2952,178
Calaveras,2/28/2021,96,11266,15,81,0,92,5337,4,2956,92
Calaveras,3/1/2021,226,11492,40,186,0,146,5405,79,3035,147
Calaveras,3/2/2021,241,11733,91,150,0,201,5568,39,3074,202
Calaveras,3/3/2021,509,12242,102,407,0,214,5490,292,3366,214
Calaveras,3/4/2021,736,12978,61,674,1,349,5459,382,3748,351
Calaveras,3/5/2021,456,13434,271,181,4,141,5292,312,4060,145
Calaveras,3/6/2021,155,13589,43,106,6,121,5385,34,4094,127
Calaveras,3/7/2021,76,13665,32,36,8,34,5385,42,4136,42
Calaveras,3/8/2021,160,13825,25,127,8,126,5486,33,4169,134
Calaveras,3/9/2021,360,14185,137,217,6,33,5201,324,4493,39
Calaveras,3/10/2021,414,14599,25,386,3,57,4906,355,4848,60
Calaveras,3/11/2021,840,15439,414,413,13,425,4931,413,5261,438
Calaveras,3/12/2021,399,15838,210,178,11,326,5200,73,5334,342
Calaveras,3/13/2021,177,16015,16,153,8,144,5322,32,5366,154
Calaveras,3/14/2021,155,16170,10,144,1,17,5209,138,5504,25
Calaveras,3/15/2021,330,16500,47,257,26,52,5014,277,5781,82
Calaveras,3/16/2021,682,17182,547,115,20,542,5437,139,5920,562
Calaveras,3/17/2021,278,17460,52,213,13,51,5277,225,6145,65
Calaveras,3/18/2021,665,18125,569,81,15,550,5729,115,6260,567
Calaveras,3/19/2021,229,18354,49,107,73,55,5686,170,6430,127
Calaveras,3/20/2021,80,18434,20,59,1,24,5656,56,6486,26
Calaveras,3/21/2021,48,18482,31,6,11,13,5645,35,6521,24
Calaveras,3/22/2021,79,18561,36,22,21,25,5637,54,6575,46
Calaveras,3/23/2021,292,18853,204,78,10,114,5589,172,6747,124
Calaveras,3/24/2021,131,18984,49,72,10,42,5552,89,6836,52
Calaveras,3/25/2021,735,19719,101,631,3,443,5709,289,7125,446
Calaveras,3/26/2021,425,20144,26,393,6,87,5469,335,7460,95
Calaveras,3/27/2021,210,20354,18,188,4,37,5343,170,7630,44
Calaveras,3/28/2021,112,20466,12,98,2,8,5251,103,7733,11
Calaveras,3/29/2021,175,20641,21,152,2,57,5195,117,7850,61
Calaveras,3/30/2021,517,21158,21,481,15,345,5384,172,8022,361
Calaveras,3/31/2021,322,21480,141,171,10,154,5381,168,8190,165
Calaveras,4/1/2021,677,22157,437,239,1,181,5071,495,8685,185
Calaveras,4/2/2021,387,22544,226,153,8,112,4919,273,8958,121
Calaveras,4/3/2021,141,22685,30,107,4,39,4860,102,9060,43
Calaveras,4/4/2021,79,22764,26,53,0,51,4883,28,9088,51
Calaveras,4/5/2021,205,22969,76,120,9,95,4878,110,9198,105
Calaveras,4/6/2021,644,23613,570,60,14,106,4463,535,9733,120
Calaveras,4/7/2021,749,24362,650,63,36,612,4975,137,9870,649
Calaveras,4/8/2021,939,25301,851,68,20,434,4927,504,10374,456
Calaveras,4/9/2021,149,25450,57,45,47,55,4936,94,10468,103
Calaveras,4/10/2021,187,25637,42,127,18,146,5060,41,10509,165
Calaveras,4/11/2021,67,25704,43,22,2,46,5087,21,10530,48
Calaveras,4/12/2021,101,25805,49,38,14,57,5115,44,10574,72
Calaveras,4/13/2021,419,26224,363,56,0,362,5424,55,10629,364
Calaveras,4/14/2021,177,26401,27,150,0,133,5514,44,10673,134
Calaveras,4/15/2021,334,26735,284,50,0,249,5681,82,10755,249
Calaveras,4/16/2021,93,26828,20,73,0,45,5682,44,10799,45
Calaveras,4/17/2021,323,27151,123,200,0,282,5923,41,10840,282
Calaveras,4/18/2021,19,27170,6,13,0,12,5928,7,10847,12
Calaveras,4/19/2021,67,27237,24,43,0,41,5945,25,10872,42
Calaveras,4/20/2021,252,27489,87,165,0,188,6071,62,10934,188
Calaveras,4/21/2021,204,27693,142,62,0,79,6028,123,11057,80
Calaveras,4/22/2021,524,28217,91,433,0,138,5784,385,11442,141
Calaveras,4/23/2021,53,28270,13,40,0,23,5779,28,11470,23
Colusa,12/18/2020,1,1,1,0,0,1,1,0,0,1
Colusa,12/21/2020,2,3,2,0,0,2,3,0,0,2
Colusa,12/22/2020,10,13,10,0,0,10,13,0,0,10
Colusa,12/23/2020,10,23,10,0,0,10,23,0,0,10
Colusa,12/24/2020,2,25,1,1,0,2,25,0,0,2
Colusa,12/27/2020,1,26,1,0,0,1,26,0,0,1
Colusa,12/28/2020,7,33,3,4,0,7,33,0,0,7
Colusa,12/29/2020,11,44,8,3,0,11,44,0,0,11
Colusa,12/30/2020,50,94,13,37,0,50,94,0,0,50
Colusa,12/31/2020,18,112,1,17,0,18,112,0,0,18
Colusa,1/4/2021,4,116,0,4,0,4,116,0,0,4
Colusa,1/5/2021,67,183,1,66,0,67,183,0,0,67
Colusa,1/6/2021,15,198,9,6,0,15,198,0,0,15
Colusa,1/7/2021,38,236,4,34,0,37,234,1,1,37
Colusa,1/8/2021,9,245,7,2,0,8,241,1,2,8
Colusa,1/9/2021,2,247,1,1,0,2,243,0,2,2
Colusa,1/10/2021,1,248,0,1,0,1,244,0,2,1
Colusa,1/11/2021,12,260,6,6,0,7,246,5,7,7
Colusa,1/12/2021,11,271,9,2,0,6,247,5,12,6
Colusa,1/13/2021,21,292,13,8,0,13,252,8,20,13
Colusa,1/14/2021,35,327,28,7,0,33,283,2,22,33
Colusa,1/15/2021,41,368,5,36,0,39,320,2,24,39
Colusa,1/16/2021,12,380,1,11,0,11,330,1,25,11
Colusa,1/17/2021,3,383,2,1,0,2,331,1,26,2
Colusa,1/18/2021,4,387,0,4,0,4,335,0,26,4
Colusa,1/19/2021,9,396,8,1,0,5,336,4,30,5
Colusa,1/20/2021,115,511,101,14,0,102,425,13,43,102
Colusa,1/21/2021,56,567,41,15,0,55,479,1,44,55
Colusa,1/22/2021,40,607,17,23,0,35,509,5,49,35
Colusa,1/23/2021,35,642,6,29,0,35,544,0,49,35
Colusa,1/25/2021,7,649,0,7,0,7,551,0,49,7
Colusa,1/26/2021,8,657,5,3,0,5,553,3,52,5
Colusa,1/27/2021,107,764,31,76,0,105,656,2,54,105
Colusa,1/28/2021,79,843,46,33,0,72,721,7,61,72
Colusa,1/29/2021,41,884,7,34,0,40,760,1,62,40
Colusa,1/30/2021,27,911,4,23,0,27,787,0,62,27
Colusa,1/31/2021,7,918,7,0,0,7,794,0,62,7
Colusa,2/1/2021,27,945,10,17,0,22,811,5,67,22
Colusa,2/2/2021,42,987,8,34,0,36,841,6,73,36
Colusa,2/3/2021,69,1056,10,59,0,59,890,10,83,59
Colusa,2/4/2021,143,1199,81,62,0,115,977,28,111,115
Colusa,2/5/2021,32,1231,8,24,0,29,1003,3,114,29
Colusa,2/6/2021,284,1515,8,276,0,273,1265,11,125,273
Colusa,2/7/2021,2,1517,1,1,0,0,1263,2,127,0
Colusa,2/8/2021,40,1557,5,35,0,37,1297,3,130,37
Colusa,2/9/2021,231,1788,14,217,0,176,1418,55,185,176
Colusa,2/10/2021,116,1904,41,75,0,73,1448,43,228,73
Colusa,2/11/2021,97,2001,36,61,0,72,1495,25,253,72
Colusa,2/12/2021,117,2118,9,108,0,79,1535,39,292,79
Colusa,2/13/2021,60,2178,8,52,0,52,1579,8,300,52
Colusa,2/14/2021,20,2198,8,12,0,14,1587,6,306,14
Colusa,2/15/2021,45,2243,10,35,0,38,1618,7,313,38
Colusa,2/16/2021,67,2310,4,63,0,66,1683,1,314,66
Colusa,2/17/2021,206,2516,143,63,0,60,1597,146,460,60
Colusa,2/18/2021,135,2651,35,100,0,112,1686,23,483,112
Colusa,2/19/2021,155,2806,19,136,0,129,1789,26,509,129
Colusa,2/20/2021,28,2834,6,22,0,12,1785,16,525,12
Colusa,2/21/2021,1,2835,1,0,0,0,1784,1,526,0
Colusa,2/22/2021,43,2878,26,17,0,29,1799,14,540,29
Colusa,2/23/2021,22,2900,6,16,0,18,1813,4,544,18
Colusa,2/24/2021,300,3200,54,246,0,158,1829,142,686,158
Colusa,2/25/2021,101,3301,54,47,0,66,1860,35,721,66
Colusa,2/26/2021,97,3398,12,85,0,58,1879,39,760,58
Colusa,2/27/2021,55,3453,4,51,0,40,1904,15,775,40
Colusa,2/28/2021,26,3479,14,12,0,18,1914,8,783,18
Colusa,3/1/2021,46,3525,15,31,0,29,1926,17,800,29
Colusa,3/2/2021,49,3574,13,36,0,26,1929,23,823,26
Colusa,3/3/2021,238,3812,39,199,0,181,2053,57,880,181
Colusa,3/4/2021,136,3948,58,78,0,80,2077,56,936,80
Colusa,3/5/2021,98,4046,25,64,9,53,2094,45,981,62
Colusa,3/6/2021,274,4320,9,265,0,37,1894,237,1218,37
Colusa,3/7/2021,8,4328,5,3,0,6,1898,2,1220,6
Colusa,3/8/2021,88,4416,20,33,35,44,1933,44,1264,79
Colusa,3/9/2021,272,4688,70,179,23,83,1850,189,1453,106
Colusa,3/10/2021,287,4975,35,216,36,201,2001,86,1539,237
Colusa,3/11/2021,416,5391,57,338,21,335,2274,81,1620,354
Colusa,3/12/2021,109,5500,18,78,13,19,2216,90,1710,32
Colusa,3/13/2021,61,5561,16,36,9,18,2200,43,1753,27
Colusa,3/14/2021,20,5581,0,18,2,6,2195,13,1766,8
Colusa,3/15/2021,69,5650,26,35,8,14,2162,55,1821,22
Colusa,3/16/2021,295,5945,15,234,46,188,2289,107,1928,234
Colusa,3/17/2021,195,6140,49,146,0,111,2316,84,2012,111
Colusa,3/18/2021,320,6460,33,216,71,197,2461,123,2135,268
Colusa,3/19/2021,78,6538,20,56,2,55,2495,23,2158,57
Colusa,3/20/2021,49,6587,7,41,1,36,2519,13,2171,37
Colusa,3/21/2021,6,6593,4,2,0,4,2521,2,2173,4
Colusa,3/22/2021,62,6655,10,43,9,40,2548,22,2195,49
Colusa,3/23/2021,81,6736,16,63,2,54,2577,27,2222,56
Colusa,3/24/2021,338,7074,57,275,6,70,2384,268,2490,75
Colusa,3/25/2021,109,7183,60,44,5,52,2384,57,2547,57
Colusa,3/26/2021,297,7480,46,247,4,244,2579,53,2600,248
Colusa,3/27/2021,62,7542,5,57,0,24,2565,38,2638,24
Colusa,3/28/2021,15,7557,6,9,0,7,2564,8,2646,7
Colusa,3/29/2021,69,7626,19,44,6,30,2561,39,2685,36
Colusa,3/30/2021,147,7773,78,67,2,75,2566,72,2757,77
Colusa,3/31/2021,228,8001,36,192,0,72,2484,154,2911,72
Colusa,4/1/2021,421,8422,65,301,55,300,2719,120,3031,355
Colusa,4/2/2021,81,8503,14,54,13,39,2729,42,3073,52
Colusa,4/3/2021,62,8565,10,29,23,14,2718,48,3121,37
Colusa,4/4/2021,18,8583,0,8,10,3,2716,15,3136,13
Colusa,4/5/2021,95,8678,25,55,15,39,2714,56,3192,54
Colusa,4/6/2021,128,8806,33,45,50,43,2722,85,3277,93
Colusa,4/7/2021,357,9163,40,294,23,133,2655,224,3501,157
Colusa,4/8/2021,427,9590,33,366,28,122,2502,302,3803,149
Colusa,4/9/2021,76,9666,21,32,23,28,2505,48,3851,51
Colusa,4/10/2021,45,9711,9,16,20,13,2506,32,3883,33
Colusa,4/11/2021,15,9726,2,11,2,7,2507,8,3891,9
Colusa,4/12/2021,31,9757,3,28,0,24,2524,7,3898,24
Colusa,4/13/2021,279,10036,23,256,0,95,2436,183,4081,95
Colusa,4/14/2021,94,10130,19,75,0,33,2408,61,4142,33
Colusa,4/15/2021,317,10447,42,275,0,129,2349,188,4330,129
Colusa,4/16/2021,80,10527,11,69,0,36,2342,43,4373,36
Colusa,4/17/2021,53,10580,7,46,0,31,2351,22,4395,31
Colusa,4/18/2021,9,10589,2,7,0,7,2356,2,4397,7
Colusa,4/19/2021,61,10650,22,39,0,17,2329,44,4441,17
Colusa,4/20/2021,176,10826,32,144,0,128,2409,48,4489,128
Colusa,4/21/2021,168,10994,59,109,0,109,2459,59,4548,109
Colusa,4/22/2021,372,11366,25,346,1,186,2460,185,4733,186
Colusa,4/23/2021,55,11421,9,46,0,17,2439,38,4771,17
Contra Costa,12/15/2020,18,18,18,0,0,18,18,0,0,18
Contra Costa,12/16/2020,522,540,522,0,0,522,540,0,0,522
Contra Costa,12/17/2020,909,1449,909,0,0,909,1449,0,0,909
Contra Costa,12/18/2020,1591,3040,1590,1,0,1591,3040,0,0,1591
Contra Costa,12/19/2020,1101,4141,1100,1,0,1101,4141,0,0,1101
Contra Costa,12/20/2020,583,4724,582,1,0,583,4724,0,0,583
Contra Costa,12/21/2020,1653,6377,1651,2,0,1653,6377,0,0,1653
Contra Costa,12/22/2020,1665,8042,1561,104,0,1665,8042,0,0,1665
Contra Costa,12/23/2020,1580,9622,1334,246,0,1580,9622,0,0,1580
Contra Costa,12/24/2020,654,10276,336,318,0,654,10276,0,0,654
Contra Costa,12/25/2020,39,10315,17,22,0,39,10315,0,0,39
Contra Costa,12/26/2020,641,10956,131,510,0,641,10956,0,0,641
Contra Costa,12/27/2020,240,11196,87,153,0,240,11196,0,0,240
Contra Costa,12/28/2020,1829,13025,860,969,0,1829,13025,0,0,1829
Contra Costa,12/29/2020,1826,14851,824,1002,0,1826,14851,0,0,1826
Contra Costa,12/30/2020,2389,17240,1214,1175,0,2388,17239,0,0,2388
Contra Costa,12/31/2020,914,18154,308,606,0,913,18152,0,0,913
Contra Costa,1/1/2021,59,18213,23,36,0,59,18211,0,0,59
Contra Costa,1/2/2021,334,18547,173,161,0,334,18545,0,0,334
Contra Costa,1/3/2021,175,18722,117,58,0,174,18719,0,0,174
Contra Costa,1/4/2021,1902,20624,1250,652,0,1881,20581,19,19,1881
Contra Costa,1/5/2021,2098,22722,1257,841,0,1839,22163,258,277,1840
Contra Costa,1/6/2021,3271,25993,2242,1029,0,2510,23921,755,1032,2513
Contra Costa,1/7/2021,3087,29080,2057,1030,0,1876,24589,1208,2240,1876
Contra Costa,1/8/2021,3379,32459,2387,992,0,1818,24854,1556,3796,1821
Contra Costa,1/9/2021,1585,34044,1133,452,0,749,24770,835,4631,751
Contra Costa,1/10/2021,359,34403,286,73,0,150,24711,209,4840,150
Contra Costa,1/11/2021,3834,38237,3143,691,0,2231,25341,1603,6443,2233
Contra Costa,1/12/2021,3906,42143,2929,977,0,2582,26601,1324,7767,2584
Contra Costa,1/13/2021,4667,46810,2880,1787,0,3734,29407,929,8696,3735
Contra Costa,1/14/2021,4301,51111,1553,2748,0,3919,32944,382,9078,3919
Contra Costa,1/15/2021,5330,56441,2457,2873,0,5007,37633,322,9400,5011
Contra Costa,1/16/2021,1716,58157,552,1164,0,1641,39199,75,9475,1641
Contra Costa,1/17/2021,1636,59793,974,662,0,1513,40592,123,9598,1516
Contra Costa,1/18/2021,3194,62987,1254,1940,0,2571,42547,617,10215,2572
Contra Costa,1/19/2021,7059,70046,3157,3902,0,6056,47608,1000,11215,6061
Contra Costa,1/20/2021,6607,76653,4053,2554,0,5375,51760,1228,12443,5380
Contra Costa,1/21/2021,6953,83606,3091,3862,0,6230,57280,718,13161,6238
Contra Costa,1/22/2021,6362,89968,2699,3663,0,5505,61940,848,14009,5508
Contra Costa,1/23/2021,2023,91991,358,1665,0,1765,63451,256,14265,1767
Contra Costa,1/24/2021,1581,93572,219,1362,0,1436,64746,145,14410,1440
Contra Costa,1/25/2021,6647,100219,3016,3631,0,5084,68272,1561,15971,5087
Contra Costa,1/26/2021,8073,108292,4676,3397,0,6238,72686,1827,17798,6241
Contra Costa,1/27/2021,8228,116520,5491,2737,0,6339,77221,1808,19606,6343
Contra Costa,1/28/2021,7430,123950,4076,3354,0,5831,81463,1593,21199,5835
Contra Costa,1/29/2021,7438,131388,3888,3550,0,6129,86289,1305,22504,6131
Contra Costa,1/30/2021,2080,133468,595,1485,0,1715,87646,358,22862,1715
Contra Costa,1/31/2021,699,134167,480,219,0,572,88094,124,22986,572
Contra Costa,2/1/2021,5518,139685,3761,1757,0,3889,90362,1624,24610,3892
Contra Costa,2/2/2021,7746,147431,5272,2474,0,5898,94415,1846,26456,5899
Contra Costa,2/3/2021,8265,155696,5458,2807,0,5631,97424,2623,29079,5632
Contra Costa,2/4/2021,7440,163136,3534,3906,0,5721,101432,1715,30794,5723
Contra Costa,2/5/2021,8422,171558,4818,3604,0,5717,104451,2698,33492,5717
Contra Costa,2/6/2021,3465,175023,2152,1313,0,2814,106616,650,34142,2815
Contra Costa,2/7/2021,979,176002,708,271,0,603,106844,375,34517,603
Contra Costa,2/8/2021,5805,181807,3438,2367,0,4330,109705,1470,35987,4331
Contra Costa,2/9/2021,8643,190450,4762,3881,0,5759,112586,2879,38866,5760
Contra Costa,2/10/2021,8624,199074,4645,3979,0,5406,114793,3203,42069,5410
Contra Costa,2/11/2021,9295,208369,4206,5089,0,5272,116052,4017,46086,5276
Contra Costa,2/12/2021,10062,218431,4607,5455,0,5455,116910,4600,50686,5458
Contra Costa,2/13/2021,4872,223303,1363,3509,0,3404,118850,1465,52151,3405
Contra Costa,2/14/2021,2088,225391,864,1224,0,1226,119215,861,53012,1226
Contra Costa,2/15/2021,4440,229831,2461,1979,0,2351,119485,2082,55094,2352
Contra Costa,2/16/2021,10408,240239,4902,5506,0,4636,118359,5765,60859,4639
Contra Costa,2/17/2021,12267,252506,6122,6145,0,5620,117347,6633,67492,5621
Contra Costa,2/18/2021,11444,263950,5954,5490,0,5309,116534,6124,73616,5311
Contra Costa,2/19/2021,11395,275345,7104,4291,0,5169,115493,6211,79827,5170
Contra Costa,2/20/2021,6441,281786,2887,3554,0,4566,118202,1859,81686,4568
Contra Costa,2/21/2021,1794,283580,1248,546,0,1081,118571,712,82398,1081
Contra Costa,2/22/2021,7527,291107,5095,2432,0,3457,117971,4059,86457,3459
Contra Costa,2/23/2021,11885,302992,7244,4641,0,5914,117931,5958,92415,5918
Contra Costa,2/24/2021,10460,313452,7668,2792,0,5038,117565,5406,97821,5040
Contra Costa,2/25/2021,11452,324904,7206,4246,0,5196,116529,6236,104057,5200
Contra Costa,2/26/2021,10683,335587,6732,3951,0,5291,116444,5377,109434,5292
Contra Costa,2/27/2021,6612,342199,4203,2409,0,4102,118043,2504,111938,4103
Contra Costa,2/28/2021,3784,345983,3116,668,0,3189,120641,592,112530,3190
Contra Costa,3/1/2021,8084,354067,6074,2007,3,4962,122500,3108,115638,4967
Contra Costa,3/2/2021,10120,364187,6305,3814,1,5247,122890,4858,120496,5248
Contra Costa,3/3/2021,11099,375286,6929,4169,1,6190,124187,4895,125391,6192
Contra Costa,3/4/2021,11844,387130,7062,4782,0,6127,124616,5698,131089,6127
Contra Costa,3/5/2021,11213,398343,6663,4545,5,6383,126188,4816,135905,6388
Contra Costa,3/6/2021,7285,405628,4002,2974,309,4709,128640,2564,138469,5016
Contra Costa,3/7/2021,3613,409241,2266,1287,60,2940,130968,672,139141,3000
Contra Costa,3/8/2021,8037,417278,3750,3984,303,5356,133961,2670,141811,5663
Contra Costa,3/9/2021,10168,427446,4992,4883,293,5020,134134,5141,146952,5314
Contra Costa,3/10/2021,12098,439544,5948,4658,1492,5459,134448,6631,153583,6945
Contra Costa,3/11/2021,12450,451994,6560,5331,559,6353,135287,6076,159659,6915
Contra Costa,3/12/2021,12513,464507,5132,6840,541,6251,135833,6246,165905,6792
Contra Costa,3/13/2021,7748,472255,3067,4258,423,3070,134659,4661,170566,3487
Contra Costa,3/14/2021,4342,476597,2540,1318,484,2075,134956,2261,172827,2558
Contra Costa,3/15/2021,9372,485969,5054,3565,753,4754,135860,4603,177430,5507
Contra Costa,3/16/2021,14238,500207,8454,5389,395,7261,136559,6957,184387,7656
Contra Costa,3/17/2021,14960,515167,10326,4423,211,8562,138960,6377,190764,8778
Contra Costa,3/18/2021,15351,530518,8526,6345,480,8790,141694,6534,197298,9268
Contra Costa,3/19/2021,15471,545989,8873,5210,1388,8294,144215,7165,204463,9686
Contra Costa,3/20/2021,10601,556590,6325,3971,305,5231,144396,5354,209817,5535
Contra Costa,3/21/2021,4431,561021,3881,463,87,2082,144220,2344,212161,2168
Contra Costa,3/22/2021,11497,572518,8664,2584,249,7071,147125,4414,216575,7319
Contra Costa,3/23/2021,15562,588080,10720,4672,170,9495,150751,6041,222616,9667
Contra Costa,3/24/2021,14940,603020,11668,3060,212,9193,154440,5717,228333,9406
Contra Costa,3/25/2021,15217,618237,11855,3077,285,9399,158342,5782,234115,9684
Contra Costa,3/26/2021,14897,633134,10676,3827,394,8794,161444,6083,240198,9185
Contra Costa,3/27/2021,10409,643543,6737,3163,509,5769,163085,4633,244831,6274
Contra Costa,3/28/2021,4121,647664,2917,1151,53,1769,162565,2342,247173,1822
Contra Costa,3/29/2021,10807,658471,8438,2254,115,7081,166050,3712,250885,7197
Contra Costa,3/30/2021,16711,675182,9104,6255,1352,11049,172800,5646,256531,12396
Contra Costa,3/31/2021,17920,693102,12549,3932,1439,11560,179471,6330,262861,13001
Contra Costa,4/1/2021,17407,710509,12198,3848,1361,11349,186145,6036,268897,12710
Contra Costa,4/2/2021,17375,727884,12834,3535,1006,11564,192914,5800,274697,12569
Contra Costa,4/3/2021,10780,738664,6430,2815,1535,6192,196066,4575,279272,7727
Contra Costa,4/4/2021,3316,741980,1312,1414,590,899,195142,2413,281685,1489
Contra Costa,4/5/2021,12044,754024,7873,3207,964,6603,197276,5432,287117,7566
Contra Costa,4/6/2021,17246,771270,11983,2992,2271,9758,201835,7470,294587,12029
Contra Costa,4/7/2021,18429,789699,12492,3147,2790,10483,207221,7927,302514,13313
Contra Costa,4/8/2021,18613,808312,12445,3267,2901,10038,211598,8551,311065,12928
Contra Costa,4/9/2021,18643,826955,11942,4230,2471,10006,215462,8614,319679,12478
Contra Costa,4/10/2021,10480,837435,3809,2130,4541,3287,216101,7181,326860,7820
Contra Costa,4/11/2021,3320,840755,1989,680,651,1129,215697,2186,329046,1782
Contra Costa,4/12/2021,11824,852579,7845,2952,1027,5604,216125,6208,335254,6636
Contra Costa,4/13/2021,17788,870367,10883,6900,5,11899,222165,5869,341123,11909
Contra Costa,4/14/2021,17467,887834,10967,6500,0,9694,224111,7751,348874,9697
Contra Costa,4/15/2021,17337,905171,10645,6691,1,8054,222929,9255,358129,8073
Contra Costa,4/16/2021,16758,921929,10451,6306,1,7570,221341,9164,367293,7576
Contra Costa,4/17/2021,11301,933230,6231,5070,0,6096,222251,5191,372484,6101
Contra Costa,4/18/2021,2724,935954,2105,619,0,1778,223090,939,373423,1778
Contra Costa,4/19/2021,11198,947152,8365,2833,0,3473,218861,7704,381127,3475
Contra Costa,4/20/2021,16509,963661,10707,5802,0,6206,214792,10279,391406,6210
Contra Costa,4/21/2021,17209,980870,14066,3143,0,6112,209847,11066,402472,6121
Contra Costa,4/22/2021,14522,995392,11652,2869,1,4753,204870,9743,412215,4766
Contra Costa,4/23/2021,11290,1006682,9441,1849,0,3076,199764,8186,420401,3080
Del Norte,12/21/2020,23,23,23,0,0,23,23,0,0,23
Del Norte,12/22/2020,46,69,46,0,0,46,69,0,0,46
Del Norte,12/23/2020,58,127,48,10,0,57,126,0,0,57
Del Norte,12/28/2020,34,161,34,0,0,34,160,0,0,34
Del Norte,12/29/2020,4,165,4,0,0,4,164,0,0,4
Del Norte,12/30/2020,67,232,55,12,0,68,232,0,0,68
Del Norte,12/31/2020,16,248,13,3,0,16,248,0,0,16
Del Norte,1/4/2021,102,350,49,53,0,102,350,0,0,102
Del Norte,1/5/2021,32,382,0,32,0,32,382,0,0,32
Del Norte,1/6/2021,77,459,18,59,0,77,459,0,0,77
Del Norte,1/7/2021,21,480,1,20,0,21,480,0,0,21
Del Norte,1/8/2021,77,557,7,70,0,77,557,0,0,77
Del Norte,1/11/2021,40,597,21,19,0,18,554,22,22,19
Del Norte,1/12/2021,51,648,32,19,0,30,563,21,43,30
Del Norte,1/13/2021,85,733,40,45,0,52,582,33,76,52
Del Norte,1/14/2021,52,785,14,38,0,46,622,6,82,46
Del Norte,1/15/2021,107,892,18,89,0,95,705,12,94,95
Del Norte,1/17/2021,1,893,1,0,0,1,706,0,94,1
Del Norte,1/18/2021,2,895,0,2,0,2,708,0,94,2
Del Norte,1/19/2021,119,1014,56,63,0,77,743,42,136,77
Del Norte,1/20/2021,158,1172,84,74,0,96,777,62,198,96
Del Norte,1/21/2021,43,1215,40,3,0,32,798,11,209,32
Del Norte,1/22/2021,19,1234,16,3,0,12,803,7,216,12
Del Norte,1/23/2021,1,1235,0,1,0,1,804,0,216,1
Del Norte,1/24/2021,1,1236,0,1,0,1,805,0,216,1
Del Norte,1/25/2021,100,1336,82,18,0,56,817,44,260,56
Del Norte,1/26/2021,18,1354,11,7,0,7,813,11,271,7
Del Norte,1/27/2021,64,1418,21,43,0,61,871,3,274,61
Del Norte,1/28/2021,291,1709,20,271,0,286,1152,5,279,286
Del Norte,1/29/2021,54,1763,21,33,0,44,1186,10,289,44
Del Norte,1/30/2021,8,1771,1,7,0,8,1194,0,289,8
Del Norte,2/1/2021,41,1812,1,40,0,26,1205,15,304,26
Del Norte,2/2/2021,142,1954,34,108,0,73,1210,68,372,73
Del Norte,2/3/2021,125,2079,40,85,0,71,1227,54,426,71
Del Norte,2/4/2021,71,2150,29,42,0,42,1240,29,455,42
Del Norte,2/5/2021,183,2333,22,161,0,120,1298,62,517,120
Del Norte,2/6/2021,312,2645,6,306,0,312,1610,0,517,312
Del Norte,2/7/2021,2,2647,1,1,0,2,1612,0,517,2
Del Norte,2/8/2021,36,2683,1,35,0,32,1640,4,521,32
Del Norte,2/9/2021,8,2691,5,3,0,2,1636,6,527,2
Del Norte,2/10/2021,143,2834,20,123,0,86,1666,56,583,86
Del Norte,2/11/2021,175,3009,58,117,0,63,1617,112,695,63
Del Norte,2/12/2021,121,3130,14,107,0,67,1630,54,749,67
Del Norte,2/13/2021,2,3132,1,1,0,2,1632,0,749,2
Del Norte,2/14/2021,3,3135,1,2,0,2,1633,1,750,2
Del Norte,2/15/2021,4,3139,0,4,0,2,1633,2,752,2
Del Norte,2/16/2021,132,3271,1,131,0,13,1527,119,871,13
Del Norte,2/17/2021,91,3362,20,71,0,24,1484,67,938,24
Del Norte,2/18/2021,77,3439,24,53,0,51,1509,26,964,51
Del Norte,2/19/2021,43,3482,17,26,0,33,1532,10,974,33
Del Norte,2/20/2021,8,3490,5,3,0,6,1536,2,976,6
Del Norte,2/22/2021,2,3492,0,2,0,2,1538,0,976,2
Del Norte,2/23/2021,106,3598,88,18,0,31,1494,75,1051,31
Del Norte,2/24/2021,152,3750,98,54,0,79,1500,73,1124,79
Del Norte,2/25/2021,475,4225,131,344,0,212,1451,261,1385,212
Del Norte,2/26/2021,212,4437,176,36,0,166,1571,46,1431,166
Del Norte,2/27/2021,152,4589,145,6,1,141,1702,11,1442,142
Del Norte,2/28/2021,4,4593,1,3,0,3,1704,1,1443,3
Del Norte,3/1/2021,28,4621,2,26,0,4,1684,24,1467,4
Del Norte,3/2/2021,220,4841,140,80,0,187,1838,33,1500,187
Del Norte,3/3/2021,159,5000,91,68,0,118,1915,41,1541,118
Del Norte,3/4/2021,120,5120,83,37,0,91,1978,28,1569,91
Del Norte,3/5/2021,91,5211,9,82,0,43,1973,48,1617,43
Del Norte,3/6/2021,466,5677,78,338,50,164,1842,302,1919,171
Del Norte,3/7/2021,2,5679,1,1,0,1,1842,1,1920,1
Del Norte,3/8/2021,28,5707,1,25,2,5,1826,23,1943,7
Del Norte,3/9/2021,194,5901,112,79,3,183,2001,11,1954,186
Del Norte,3/10/2021,218,6119,97,93,28,132,2075,86,2040,160
Del Norte,3/11/2021,152,6271,55,92,5,104,2136,48,2088,109
Del Norte,3/12/2021,177,6448,89,88,0,124,2207,53,2141,124
Del Norte,3/13/2021,94,6542,93,1,0,91,2295,3,2144,91
Del Norte,3/14/2021,1,6543,0,1,0,1,2295,1,2145,1
Del Norte,3/15/2021,38,6581,0,38,0,34,2325,4,2149,34
Del Norte,3/16/2021,280,6861,136,144,0,259,2563,21,2170,259
Del Norte,3/17/2021,282,7143,95,185,2,168,2619,114,2284,170
Del Norte,3/18/2021,284,7427,107,174,3,148,2635,135,2419,151
Del Norte,3/19/2021,266,7693,159,101,6,91,2557,175,2594,97
Del Norte,3/20/2021,158,7851,155,3,0,16,2431,142,2736,16
Del Norte,3/21/2021,4,7855,2,2,0,2,2431,2,2738,2
Del Norte,3/22/2021,42,7897,3,38,1,39,2468,3,2741,40
Del Norte,3/23/2021,333,8230,163,152,18,164,2482,167,2908,181
Del Norte,3/24/2021,395,8625,107,247,41,241,2610,154,3062,282
Del Norte,3/25/2021,194,8819,90,104,0,86,2589,107,3169,86
Del Norte,3/26/2021,227,9046,108,119,0,194,2750,33,3202,194
Del Norte,3/27/2021,108,9154,87,4,17,17,2693,91,3293,34
Del Norte,3/28/2021,4,9158,2,2,0,1,2691,3,3296,1
Del Norte,3/29/2021,57,9215,6,34,17,32,2715,25,3321,49
Del Norte,3/30/2021,336,9551,118,207,11,124,2638,212,3533,135
Del Norte,3/31/2021,346,9897,100,229,17,190,2691,154,3687,207
Del Norte,4/1/2021,166,10063,60,72,34,71,2702,94,3781,105
Del Norte,4/2/2021,232,10295,79,104,49,76,2672,156,3937,126
Del Norte,4/3/2021,103,10398,82,2,19,4,2597,98,4035,23
Del Norte,4/4/2021,4,10402,0,0,4,0,2597,4,4039,4
Del Norte,4/5/2021,53,10455,5,44,4,46,2640,7,4046,50
Del Norte,4/6/2021,378,10833,119,222,37,145,2594,229,4275,183
Del Norte,4/7/2021,425,11258,115,251,59,283,2795,141,4416,342
Del Norte,4/8/2021,233,11491,54,111,68,111,2852,122,4538,179
Del Norte,4/9/2021,201,11692,47,80,74,97,2918,103,4641,169
Del Norte,4/10/2021,48,11740,27,4,17,27,2941,21,4662,44
Del Norte,4/11/2021,12,11752,3,2,7,2,2940,10,4672,9
Del Norte,4/12/2021,28,11780,1,9,18,1,2933,26,4698,19
Del Norte,4/13/2021,296,12076,49,247,0,155,2947,141,4839,155
Del Norte,4/14/2021,325,12401,23,302,0,136,2899,189,5028,141
Del Norte,4/15/2021,162,12563,30,132,0,44,2826,118,5146,45
Del Norte,4/16/2021,155,12718,34,121,0,57,2786,98,5244,58
Del Norte,4/17/2021,99,12817,69,30,0,94,2875,5,5249,94
Del Norte,4/18/2021,4,12821,3,1,0,3,2877,1,5250,3
Del Norte,4/19/2021,50,12871,6,44,0,8,2843,42,5292,8
Del Norte,4/20/2021,208,13079,40,168,0,74,2783,134,5426,74
Del Norte,4/21/2021,290,13369,24,266,0,66,2629,223,5649,69
Del Norte,4/22/2021,117,13486,18,99,0,63,2638,54,5703,63
Del Norte,4/23/2021,111,13597,2,109,0,20,2567,91,5794,20
El Dorado,12/15/2020,12,12,12,0,0,12,12,0,0,12
El Dorado,12/16/2020,40,52,40,0,0,40,52,0,0,40
El Dorado,12/17/2020,30,82,30,0,0,30,82,0,0,30
El Dorado,12/18/2020,236,318,236,0,0,236,318,0,0,236
El Dorado,12/19/2020,116,434,116,0,0,116,434,0,0,116
El Dorado,12/20/2020,85,519,85,0,0,85,519,0,0,85
El Dorado,12/21/2020,307,826,306,1,0,307,826,0,0,307
El Dorado,12/22/2020,238,1064,214,24,0,238,1064,0,0,238
El Dorado,12/23/2020,189,1253,139,50,0,189,1253,0,0,189
El Dorado,12/24/2020,87,1340,66,21,0,87,1340,0,0,87
El Dorado,12/25/2020,8,1348,8,0,0,8,1348,0,0,8
El Dorado,12/26/2020,44,1392,26,18,0,44,1392,0,0,44
El Dorado,12/27/2020,37,1429,33,4,0,37,1429,0,0,37
El Dorado,12/28/2020,216,1645,169,47,0,216,1645,0,0,216
El Dorado,12/29/2020,456,2101,140,316,0,456,2101,0,0,456
El Dorado,12/30/2020,504,2605,136,368,0,504,2605,0,0,504
El Dorado,12/31/2020,109,2714,69,40,0,109,2714,0,0,109
El Dorado,1/1/2021,7,2721,4,3,0,7,2721,0,0,7
El Dorado,1/2/2021,151,2872,140,11,0,151,2872,0,0,151
El Dorado,1/3/2021,92,2964,17,75,0,92,2964,0,0,92
El Dorado,1/4/2021,189,3153,62,127,0,189,3153,0,0,189
El Dorado,1/5/2021,205,3358,50,155,0,189,3326,16,16,189
El Dorado,1/6/2021,262,3620,189,73,0,198,3460,64,80,198
El Dorado,1/7/2021,328,3948,135,193,0,258,3648,70,150,258
El Dorado,1/8/2021,974,4922,500,474,0,771,4217,203,353,772
El Dorado,1/9/2021,193,5115,157,36,0,125,4274,68,421,125
El Dorado,1/10/2021,180,5295,129,51,0,111,4316,69,490,111
El Dorado,1/11/2021,658,5953,292,366,0,460,4579,197,687,460
El Dorado,1/12/2021,692,6645,421,271,0,444,4775,248,935,444
El Dorado,1/13/2021,698,7343,295,403,0,538,5153,160,1095,538
El Dorado,1/14/2021,688,8031,218,470,0,593,5651,95,1190,593
El Dorado,1/15/2021,677,8708,184,493,0,605,6184,72,1262,605
El Dorado,1/16/2021,171,8879,103,68,0,144,6301,27,1289,144
El Dorado,1/17/2021,99,8978,47,52,0,82,6366,17,1306,82
El Dorado,1/18/2021,417,9395,138,279,0,349,6647,68,1374,349
El Dorado,1/19/2021,643,10038,352,291,0,494,6993,149,1523,495
El Dorado,1/20/2021,1009,11047,686,323,0,897,7779,111,1634,897
El Dorado,1/21/2021,1151,12198,570,581,0,945,8559,165,1799,945
El Dorado,1/22/2021,1097,13295,705,392,0,1044,9551,52,1851,1044
El Dorado,1/23/2021,736,14031,617,119,0,625,10065,111,1962,625
El Dorado,1/24/2021,126,14157,76,50,0,107,10153,19,1981,107
El Dorado,1/25/2021,610,14767,204,406,0,522,10587,88,2069,522
El Dorado,1/26/2021,673,15440,363,310,0,569,11053,104,2173,570
El Dorado,1/27/2021,926,16366,329,597,0,590,11306,337,2510,590
El Dorado,1/28/2021,1101,17467,451,650,0,742,11689,359,2869,742
El Dorado,1/29/2021,973,18440,488,485,0,744,12206,228,3097,745
El Dorado,1/30/2021,611,19051,359,252,0,450,12495,161,3258,450
El Dorado,1/31/2021,209,19260,188,21,0,180,12646,29,3287,180
El Dorado,2/1/2021,799,20059,368,431,0,655,13158,143,3430,655
El Dorado,2/2/2021,838,20897,367,471,0,677,13674,161,3591,677
El Dorado,2/3/2021,898,21795,475,423,0,686,14148,212,3803,686
El Dorado,2/4/2021,1264,23059,721,543,0,871,14626,393,4196,871
El Dorado,2/5/2021,1478,24537,595,883,0,864,14911,579,4775,864
El Dorado,2/6/2021,638,25175,333,305,0,530,15334,108,4883,531
El Dorado,2/7/2021,256,25431,176,80,0,192,15462,64,4947,192
El Dorado,2/8/2021,877,26308,416,461,0,604,15793,273,5220,604
El Dorado,2/9/2021,901,27209,487,414,0,479,15850,422,5642,479
El Dorado,2/10/2021,1245,28454,730,515,0,654,15914,590,6232,654
El Dorado,2/11/2021,2136,30590,881,1255,0,955,15690,1180,7412,956
El Dorado,2/12/2021,1564,32154,822,742,0,678,15483,886,8298,679
El Dorado,2/13/2021,976,33130,668,308,0,432,15374,541,8839,432
El Dorado,2/14/2021,481,33611,153,328,0,398,15689,83,8922,398
El Dorado,2/15/2021,1179,34790,387,792,0,826,16165,353,9275,829
El Dorado,2/16/2021,1188,35978,529,659,0,675,16329,512,9787,676
El Dorado,2/17/2021,898,36876,373,525,0,419,16271,479,10266,421
El Dorado,2/18/2021,2077,38953,1005,1072,0,1349,16893,727,10993,1349
El Dorado,2/19/2021,1164,40117,602,562,0,646,17022,518,11511,647
El Dorado,2/20/2021,915,41032,435,480,0,667,17447,242,11753,667
El Dorado,2/21/2021,282,41314,225,57,0,99,17364,182,11935,99
El Dorado,2/22/2021,869,42183,434,435,0,285,17066,583,12518,285
El Dorado,2/23/2021,835,43018,471,364,0,346,16924,488,13006,346
El Dorado,2/24/2021,1004,44022,439,565,0,411,16743,593,13599,412
El Dorado,2/25/2021,1620,45642,883,737,0,715,16561,899,14498,717
El Dorado,2/26/2021,2347,47989,1481,866,0,1583,17382,762,15260,1583
El Dorado,2/27/2021,1654,49643,439,1215,0,1215,18161,436,15696,1215
El Dorado,2/28/2021,570,50213,204,366,0,419,18430,151,15847,420
El Dorado,3/1/2021,1114,51327,451,663,0,606,18529,507,16354,606
El Dorado,3/2/2021,895,52222,266,629,0,457,18550,436,16790,457
El Dorado,3/3/2021,1666,53888,460,1206,0,1139,19170,521,17311,1141
El Dorado,3/4/2021,2480,56368,1530,950,0,1209,19111,1268,18579,1209
El Dorado,3/5/2021,1559,57927,422,1132,5,1029,19620,525,19104,1034
El Dorado,3/6/2021,730,58657,208,488,34,384,19692,346,19450,418
El Dorado,3/7/2021,400,59057,197,185,18,237,19786,161,19611,255
El Dorado,3/8/2021,1318,60375,364,884,70,851,20243,464,20075,921
El Dorado,3/9/2021,960,61335,227,666,67,567,20499,378,20453,634
El Dorado,3/10/2021,932,62267,342,535,55,536,20700,390,20843,591
El Dorado,3/11/2021,2984,65251,1823,979,182,1362,20636,1607,22450,1543
El Dorado,3/12/2021,1764,67015,619,899,246,732,20596,1018,23468,978
El Dorado,3/13/2021,1057,68072,343,431,283,371,20565,683,24151,652
El Dorado,3/14/2021,792,68864,207,473,112,279,20443,513,24664,391
El Dorado,3/15/2021,1396,70260,300,970,126,607,20392,785,25449,734
El Dorado,3/16/2021,1207,71467,404,659,144,566,20467,635,26084,710
El Dorado,3/17/2021,1079,72546,351,634,94,696,20874,383,26467,790
El Dorado,3/18/2021,2966,75512,1746,1176,44,1979,21917,980,27447,2023
El Dorado,3/19/2021,1099,76611,358,597,144,625,22213,474,27921,770
El Dorado,3/20/2021,937,77548,267,653,17,359,22022,567,28488,376
El Dorado,3/21/2021,1024,78572,418,601,5,935,22874,88,28576,940
El Dorado,3/22/2021,1498,80070,487,929,82,1190,23843,303,28879,1272
El Dorado,3/23/2021,1143,81213,449,602,92,740,24281,394,29273,832
El Dorado,3/24/2021,1453,82666,620,637,196,691,24421,747,30020,887
El Dorado,3/25/2021,2467,85133,1666,698,103,1366,24794,1096,31116,1469
El Dorado,3/26/2021,1805,86938,698,998,109,958,25031,831,31947,1068
El Dorado,3/27/2021,1294,88232,187,1103,4,319,24385,969,32916,323
El Dorado,3/28/2021,613,88845,181,423,9,196,24176,414,33330,205
El Dorado,3/29/2021,1299,90144,431,853,15,817,24529,479,33809,832
El Dorado,3/30/2021,1326,91470,408,827,91,681,24660,640,34449,771
El Dorado,3/31/2021,1532,93002,579,891,62,699,24589,831,35280,760
El Dorado,4/1/2021,3193,96195,1747,1363,83,1516,24515,1675,36955,1601
El Dorado,4/2/2021,1860,98055,554,1212,94,745,24243,1111,38066,839
El Dorado,4/3/2021,734,98789,284,330,120,216,24063,515,38581,335
El Dorado,4/4/2021,266,99055,84,135,47,95,24035,170,38751,142
El Dorado,4/5/2021,1415,100470,422,900,93,592,23901,819,39570,685
El Dorado,4/6/2021,1404,101874,516,668,220,447,23613,955,40525,667
El Dorado,4/7/2021,1559,103433,551,564,444,553,23605,1003,41528,995
El Dorado,4/8/2021,2666,106099,1722,708,236,1115,23411,1544,43072,1350
El Dorado,4/9/2021,1402,107501,440,744,218,556,23340,843,43915,772
El Dorado,4/10/2021,814,108315,219,486,109,473,23583,339,44254,582
El Dorado,4/11/2021,693,109008,451,226,16,204,23314,489,44743,220
El Dorado,4/12/2021,1280,110288,499,635,146,564,23315,709,45452,710
El Dorado,4/13/2021,1116,111404,608,508,0,519,23241,593,46045,519
El Dorado,4/14/2021,1060,112464,434,625,1,361,22916,687,46732,362
El Dorado,4/15/2021,2478,114942,1670,808,0,964,22370,1511,48243,965
El Dorado,4/16/2021,1442,116384,511,931,0,607,22148,830,49073,608
El Dorado,4/17/2021,738,117122,191,547,0,472,22355,265,49338,472
El Dorado,4/18/2021,957,118079,74,883,0,393,22185,563,49901,393
El Dorado,4/19/2021,1690,119769,433,1257,0,685,21871,999,50900,685
El Dorado,4/20/2021,1097,120866,346,751,0,454,21686,639,51539,454
El Dorado,4/21/2021,1113,121979,450,660,3,563,21706,544,52083,564
El Dorado,4/22/2021,2285,124264,1542,743,0,892,21206,1392,53475,892
El Dorado,4/23/2021,477,124741,125,352,0,245,21222,229,53704,245
Fresno,12/15/2020,2,2,2,0,0,2,2,0,0,2
Fresno,12/16/2020,121,123,121,0,0,121,123,0,0,121
Fresno,12/17/2020,120,243,120,0,0,120,243,0,0,120
Fresno,12/18/2020,344,587,344,0,0,344,587,0,0,344
Fresno,12/19/2020,157,744,157,0,0,157,744,0,0,157
Fresno,12/20/2020,257,1001,255,2,0,257,1001,0,0,257
Fresno,12/21/2020,925,1926,924,1,0,957,1958,0,0,957
Fresno,12/22/2020,901,2827,872,29,0,905,2863,0,0,905
Fresno,12/23/2020,1084,3911,1047,37,0,1085,3948,0,0,1085
Fresno,12/24/2020,581,4492,562,19,0,581,4529,0,0,581
Fresno,12/25/2020,2,4494,1,1,0,2,4531,0,0,2
Fresno,12/26/2020,722,5216,713,9,0,722,5253,0,0,722
Fresno,12/27/2020,300,5516,204,96,0,300,5553,0,0,300
Fresno,12/28/2020,1061,6577,774,287,0,1061,6614,0,0,1061
Fresno,12/29/2020,1769,8346,1040,729,0,1767,8380,1,1,1767
Fresno,12/30/2020,980,9326,477,503,0,980,9360,0,1,980
Fresno,12/31/2020,894,10220,310,584,0,893,10253,0,1,893
Fresno,1/1/2021,9,10229,3,6,0,9,10262,0,1,9
Fresno,1/2/2021,1031,11260,717,314,0,1031,11293,0,1,1031
Fresno,1/3/2021,153,11413,128,25,0,153,11446,0,1,153
Fresno,1/4/2021,612,12025,374,238,0,612,12058,0,1,612
Fresno,1/5/2021,776,12801,311,465,0,702,12686,74,75,702
Fresno,1/6/2021,974,13775,346,628,0,802,13316,172,247,802
Fresno,1/7/2021,1887,15662,916,971,0,1633,14698,254,501,1636
Fresno,1/8/2021,1779,17441,614,1165,0,1415,15751,362,863,1415
Fresno,1/9/2021,628,18069,386,242,0,354,15831,274,1137,354
Fresno,1/10/2021,515,18584,485,30,0,202,15720,313,1450,202
Fresno,1/11/2021,2157,20741,1751,406,0,1464,16494,693,2143,1467
Fresno,1/12/2021,2522,23263,1826,696,0,1675,17322,849,2992,1677
Fresno,1/13/2021,3534,26797,2421,1113,0,2678,19146,856,3848,2680
Fresno,1/14/2021,4147,30944,2198,1949,0,3677,22354,469,4317,3677
Fresno,1/15/2021,3640,34584,2531,1109,0,3282,25282,358,4675,3286
Fresno,1/16/2021,3150,37734,2308,842,0,2686,27506,463,5138,2687
Fresno,1/17/2021,977,38711,555,422,0,779,28087,198,5336,779
Fresno,1/18/2021,3072,41783,2367,705,0,2408,29835,662,5998,2410
Fresno,1/19/2021,4323,46106,2540,1783,0,3676,32867,647,6645,3679
Fresno,1/20/2021,2994,49100,1186,1808,0,2694,35263,301,6946,2697
Fresno,1/21/2021,4346,53446,1999,2347,0,3999,38938,329,7275,4004
Fresno,1/22/2021,3308,56754,1346,1962,0,2920,41488,371,7646,2921
Fresno,1/23/2021,3042,59796,1969,1073,0,2319,43092,722,8368,2326
Fresno,1/24/2021,552,60348,372,180,0,347,43237,205,8573,350
Fresno,1/25/2021,2338,62686,864,1474,0,1852,44607,486,9059,1856
Fresno,1/26/2021,2019,64705,584,1435,0,1316,45223,701,9760,1317
Fresno,1/27/2021,2254,66959,1164,1090,0,1734,46441,519,10279,1737
Fresno,1/28/2021,4470,71429,3037,1433,0,3455,48888,1011,11290,3458
Fresno,1/29/2021,1700,73129,984,716,0,1403,49998,294,11584,1404
Fresno,1/30/2021,1443,74572,550,893,0,1028,50611,415,11999,1028
Fresno,1/31/2021,225,74797,216,9,0,71,50528,154,12153,71
Fresno,2/1/2021,3327,78124,1662,1665,0,1815,50850,1511,13664,1833
Fresno,2/2/2021,2715,80839,551,2164,0,1585,51335,1116,14780,1601
Fresno,2/3/2021,3532,84371,2095,1437,0,1518,50854,2000,16780,1519
Fresno,2/4/2021,4192,88563,1894,2298,0,1929,50555,2233,19013,1934
Fresno,2/5/2021,5323,93886,2723,2600,0,2305,49849,3013,22026,2307
Fresno,2/6/2021,2933,96819,2046,887,0,975,48871,1955,23981,977
Fresno,2/7/2021,465,97284,286,179,0,271,48949,193,24174,271
Fresno,2/8/2021,4273,101557,2293,1980,0,1810,48329,2439,26613,1819
Fresno,2/9/2021,5327,106884,2081,3246,0,3118,49321,2134,28747,3126
Fresno,2/10/2021,3875,110759,1234,2641,0,1985,49482,1835,30582,1996
Fresno,2/11/2021,6440,117199,2088,4352,0,3380,49821,3046,33628,3385
Fresno,2/12/2021,5371,122570,1382,3989,0,2743,49961,2609,36237,2749
Fresno,2/13/2021,3729,126299,1546,2183,0,2079,50406,1639,37876,2084
Fresno,2/14/2021,1561,127860,281,1280,0,848,50544,712,38588,850
Fresno,2/15/2021,2887,130747,271,2616,0,1783,51231,1100,39688,1787
Fresno,2/16/2021,6677,137424,2400,4277,0,4244,53065,2416,42104,4250
Fresno,2/17/2021,5330,142754,2454,2876,0,2981,53745,2305,44409,2985
Fresno,2/18/2021,6854,149608,2902,3952,0,2579,52109,4226,48635,2590
Fresno,2/19/2021,3833,153441,1099,2734,0,1828,51945,1995,50630,1831
Fresno,2/20/2021,4534,157975,2500,2034,0,3055,53533,1473,52103,3061
Fresno,2/21/2021,186,158161,169,17,0,127,53614,46,52149,127
Fresno,2/22/2021,2227,160388,1000,1227,0,1224,53847,995,53144,1228
Fresno,2/23/2021,3877,164265,1470,2407,0,3018,56018,849,53993,3020
Fresno,2/24/2021,4171,168436,1492,2679,0,3427,58715,733,54726,3430
Fresno,2/25/2021,7468,175904,2511,4957,0,6013,63344,1391,56117,6020
Fresno,2/26/2021,8311,184215,3029,5282,0,7031,69121,1259,57376,7036
Fresno,2/27/2021,6285,190500,2196,4089,0,5602,74054,675,58051,5608
Fresno,2/28/2021,1632,192132,530,1102,0,1548,75529,73,58124,1548
Fresno,3/1/2021,4901,197033,1289,3612,0,3598,77842,1293,59417,3606
Fresno,3/2/2021,8485,205518,2301,6184,0,7127,83657,1335,60752,7150
Fresno,3/3/2021,6678,212196,1610,5067,1,5666,88439,999,61751,5781
Fresno,3/4/2021,8469,220665,2527,5942,0,6955,93914,1488,63239,6963
Fresno,3/5/2021,7931,228596,2698,5232,1,6918,100026,882,64121,6994
Fresno,3/6/2021,6460,235056,3537,2806,117,5516,104725,938,65059,5637
Fresno,3/7/2021,1473,236529,675,764,34,1246,105781,225,65284,1281
Fresno,3/8/2021,5038,241567,1996,2890,152,3867,108647,1164,66448,4030
Fresno,3/9/2021,7043,248610,2368,4406,269,3945,109816,3080,69528,4249
Fresno,3/10/2021,6609,255219,2742,3475,392,5215,114048,1384,70912,5616
Fresno,3/11/2021,11334,266553,4536,6232,566,6190,115777,5103,76015,6832
Fresno,3/12/2021,11491,278044,4917,6124,450,8507,121907,2967,78982,9097
Fresno,3/13/2021,8155,286199,3897,3236,1022,3916,122698,4220,83202,5011
Fresno,3/14/2021,1746,287945,466,1000,280,659,122557,1078,84280,937
Fresno,3/15/2021,6872,294817,2953,3749,170,4714,125480,2144,86424,5067
Fresno,3/16/2021,10044,304861,4402,5248,394,6043,128040,3973,90397,6533
Fresno,3/17/2021,8421,313282,3867,3859,695,5649,132010,2754,93151,6724
Fresno,3/18/2021,12231,325513,6555,5047,629,8023,136918,4166,97317,9074
Fresno,3/19/2021,10737,336250,5621,4502,614,7274,141664,3436,100753,8182
Fresno,3/20/2021,7363,343613,4409,2642,312,4511,143926,2830,103583,5092
Fresno,3/21/2021,1770,345383,1199,200,371,960,144452,806,104389,1332
Fresno,3/22/2021,5632,351015,2887,2150,595,3841,147311,1776,106165,4635
Fresno,3/23/2021,10532,361547,5236,4804,492,6075,149865,4440,110605,6994
Fresno,3/24/2021,8592,370139,3630,4133,829,4733,151653,3827,114432,5615
Fresno,3/25/2021,12039,382178,5572,5685,782,6186,152888,5815,120247,7050
Fresno,3/26/2021,11984,394162,5321,6021,642,5278,152166,6661,126908,5939
Fresno,3/27/2021,9358,403520,4123,4151,1084,2936,149798,6391,133299,4023
Fresno,3/28/2021,3277,406797,1197,1393,687,1257,149988,2013,135312,2203
Fresno,3/29/2021,5987,412784,1976,3470,541,2906,150391,3057,138369,3460
Fresno,3/30/2021,10719,423503,4199,5639,881,4437,149450,6260,144629,5319
Fresno,3/31/2021,9204,432707,3307,4924,973,3836,148929,5331,149960,4810
Fresno,4/1/2021,11267,443974,4048,6371,848,3912,146366,7282,157242,4719
Fresno,4/2/2021,11452,455426,4390,6278,784,4196,144245,7107,164349,4986
Fresno,4/3/2021,6129,461555,3372,2509,248,2208,142832,3907,168256,2494
Fresno,4/4/2021,1488,463043,534,911,43,564,142523,916,169172,607
Fresno,4/5/2021,8209,471252,4436,2983,790,2517,140215,5684,174856,3376
Fresno,4/6/2021,9451,480703,3935,4341,1175,3582,139149,5837,180693,4771
Fresno,4/7/2021,10277,490980,5284,3813,1180,3539,137192,6705,187398,4748
Fresno,4/8/2021,10768,501748,5109,4528,1131,3501,134639,7230,194628,4677
Fresno,4/9/2021,10608,512356,5068,4191,1349,3579,132597,6993,201621,4951
Fresno,4/10/2021,7799,520155,5104,2175,520,3714,132752,4080,205701,4235
Fresno,4/11/2021,1387,521542,928,369,90,450,132359,932,206633,539
Fresno,4/12/2021,7083,528625,3752,2428,903,2309,130817,4755,211388,3213
Fresno,4/13/2021,8871,537496,4211,4590,70,3500,129137,5342,216730,3662
Fresno,4/14/2021,8754,546250,5126,3628,0,3615,127689,5108,221838,3660
Fresno,4/15/2021,7744,553994,3603,4139,2,3000,125976,4718,226556,3005
Fresno,4/16/2021,8866,562860,4193,4671,2,3803,124761,5025,231581,3810
Fresno,4/17/2021,5557,568417,3726,1831,0,2710,124640,2832,234413,2711
Fresno,4/18/2021,1016,569433,547,469,0,472,124570,542,234955,472
Fresno,4/19/2021,5370,574803,2899,2467,4,2166,123570,3173,238128,2173
Fresno,4/20/2021,6766,581569,3287,3471,8,2522,121880,4221,242349,2531
Fresno,4/21/2021,6105,587674,3378,2719,8,2543,120894,3541,245890,2555
Fresno,4/22/2021,5934,593608,2955,2978,1,2095,119193,3799,249689,2098
Fresno,4/23/2021,3360,596968,2138,1200,22,1560,118987,1777,251466,1571
Glenn,12/17/2020,1,1,1,0,0,1,1,0,0,1
Glenn,12/19/2020,1,2,1,0,0,1,2,0,0,1
Glenn,12/20/2020,1,3,1,0,0,1,3,0,0,1
Glenn,12/21/2020,11,14,11,0,0,11,14,0,0,11
Glenn,12/22/2020,59,73,59,0,0,59,73,0,0,59
Glenn,12/23/2020,27,100,27,0,0,27,100,0,0,27
Glenn,12/24/2020,9,109,9,0,0,9,109,0,0,9
Glenn,12/26/2020,2,111,2,0,0,2,111,0,0,2
Glenn,12/27/2020,4,115,4,0,0,4,115,0,0,4
Glenn,12/28/2020,21,136,21,0,0,21,136,0,0,21
Glenn,12/29/2020,82,218,82,0,0,82,218,0,0,82
Glenn,12/30/2020,128,346,106,22,0,128,346,0,0,128
Glenn,12/31/2020,38,384,9,29,0,38,384,0,0,38
Glenn,1/2/2021,2,386,2,0,0,2,386,0,0,2
Glenn,1/4/2021,7,393,5,2,0,7,393,0,0,7
Glenn,1/5/2021,9,402,8,1,0,9,402,0,0,9
Glenn,1/6/2021,60,462,8,52,0,60,462,0,0,60
Glenn,1/7/2021,67,529,12,55,0,65,525,2,2,65
Glenn,1/8/2021,11,540,9,2,0,11,536,0,2,11
Glenn,1/10/2021,1,541,1,0,0,0,535,1,3,0
Glenn,1/11/2021,30,571,30,0,0,12,529,18,21,12
Glenn,1/12/2021,42,613,37,5,0,14,515,28,49,14
Glenn,1/13/2021,153,766,88,65,0,109,580,44,93,109
Glenn,1/14/2021,185,951,96,89,0,175,745,10,103,175
Glenn,1/15/2021,42,993,34,8,0,37,777,5,108,37
Glenn,1/16/2021,34,1027,14,20,0,24,791,10,118,24
Glenn,1/17/2021,4,1031,2,2,0,2,791,2,120,2
Glenn,1/18/2021,17,1048,16,1,0,9,792,8,128,9
Glenn,1/19/2021,31,1079,20,11,0,14,789,17,145,14
Glenn,1/20/2021,163,1242,94,69,0,82,790,81,226,82
Glenn,1/21/2021,124,1366,98,26,0,30,726,94,320,30
Glenn,1/22/2021,337,1703,63,274,0,330,1049,7,327,330
Glenn,1/23/2021,14,1717,7,7,0,12,1059,2,329,12
Glenn,1/24/2021,2,1719,2,0,0,2,1061,0,329,2
Glenn,1/25/2021,27,1746,9,18,0,24,1082,3,332,24
Glenn,1/26/2021,29,1775,13,16,0,23,1099,6,338,23
Glenn,1/27/2021,187,1962,13,174,0,166,1244,21,359,166
Glenn,1/28/2021,146,2108,8,138,0,116,1330,30,389,116
Glenn,1/29/2021,296,2404,12,284,0,282,1598,14,403,282
Glenn,1/30/2021,5,2409,0,5,0,5,1603,0,403,5
Glenn,1/31/2021,1,2410,0,1,0,1,1604,0,403,1
Glenn,2/1/2021,28,2438,10,18,0,16,1608,12,415,16
Glenn,2/2/2021,28,2466,13,15,0,19,1618,9,424,19
Glenn,2/3/2021,207,2673,58,149,0,112,1635,95,519,112
Glenn,2/4/2021,150,2823,84,66,0,45,1575,105,624,45
Glenn,2/5/2021,319,3142,24,295,0,300,1856,19,643,300
Glenn,2/6/2021,14,3156,2,12,0,13,1868,1,644,13
Glenn,2/7/2021,2,3158,2,0,0,2,1870,0,644,2
Glenn,2/8/2021,21,3179,17,4,0,4,1857,17,661,4
Glenn,2/9/2021,49,3228,20,29,0,36,1880,13,674,36
Glenn,2/10/2021,138,3366,19,119,0,64,1870,74,748,64
Glenn,2/11/2021,232,3598,132,100,0,149,1936,83,831,149
Glenn,2/12/2021,420,4018,99,321,0,356,2228,64,895,356
Glenn,2/13/2021,34,4052,7,27,0,16,2226,18,913,16
Glenn,2/14/2021,1,4053,0,1,0,1,2227,0,913,1
Glenn,2/15/2021,8,4061,0,8,0,8,2235,0,913,8
Glenn,2/16/2021,39,4100,9,30,0,21,2238,18,931,21
Glenn,2/17/2021,380,4480,15,365,0,302,2462,78,1009,302
Glenn,2/18/2021,135,4615,100,35,0,111,2549,24,1033,111
Glenn,2/19/2021,303,4918,17,286,0,29,2304,274,1307,29
Glenn,2/20/2021,8,4926,0,8,0,0,2296,8,1315,0
Glenn,2/22/2021,33,4959,14,19,0,17,2297,16,1331,17
Glenn,2/23/2021,40,4999,10,30,0,28,2313,12,1343,28
Glenn,2/24/2021,221,5220,15,206,0,47,2186,174,1517,47
Glenn,2/25/2021,262,5482,148,114,0,118,2160,144,1661,118
Glenn,2/26/2021,304,5786,24,280,0,20,1897,283,1944,20
Glenn,2/27/2021,15,5801,5,10,0,5,1893,9,1953,5
Glenn,2/28/2021,6,5807,3,3,0,3,1894,2,1955,3
Glenn,3/1/2021,28,5835,6,22,0,12,1890,16,1971,12
Glenn,3/2/2021,35,5870,7,28,0,17,1889,18,1989,17
Glenn,3/3/2021,193,6063,37,156,0,101,1899,91,2080,101
Glenn,3/4/2021,520,6583,175,345,0,376,2131,144,2224,376
Glenn,3/5/2021,355,6938,47,308,0,34,1844,321,2545,34
Glenn,3/6/2021,26,6964,3,22,1,9,1837,17,2562,10
Glenn,3/7/2021,5,6969,0,5,0,3,1839,1,2563,3
Glenn,3/8/2021,20,6989,2,17,1,18,1856,2,2565,19
Glenn,3/9/2021,82,7071,11,68,3,54,1884,28,2593,56
Glenn,3/10/2021,171,7242,68,101,2,95,1905,76,2669,97
Glenn,3/11/2021,584,7826,170,391,23,454,2252,130,2799,477
Glenn,3/12/2021,417,8243,14,342,61,41,1978,376,3175,102
Glenn,3/13/2021,12,8255,1,3,8,1,1976,11,3186,9
Glenn,3/14/2021,3,8258,1,2,0,2,1977,1,3187,2
Glenn,3/15/2021,75,8333,15,55,5,60,2027,15,3202,65
Glenn,3/16/2021,106,8439,33,62,11,65,2062,41,3243,76
Glenn,3/17/2021,417,8856,97,313,7,116,1882,301,3544,121
Glenn,3/18/2021,520,9376,214,50,256,145,1907,375,3919,400
Glenn,3/19/2021,91,9467,16,69,6,70,1963,20,3939,76
Glenn,3/20/2021,121,9588,1,119,1,119,2081,2,3941,120
Glenn,3/21/2021,6,9594,5,0,1,3,2083,2,3943,4
Glenn,3/22/2021,116,9710,53,55,8,96,2169,18,3961,104
Glenn,3/23/2021,173,9883,66,56,51,100,2248,72,4033,151
Glenn,3/24/2021,205,10088,100,100,5,133,2315,71,4104,138
Glenn,3/25/2021,455,10543,226,135,94,326,2607,128,4232,420
Glenn,3/26/2021,225,10768,34,155,36,175,2768,50,4282,211
Glenn,3/27/2021,151,10919,21,125,5,141,2904,10,4292,146
Glenn,3/28/2021,15,10934,10,5,0,10,2909,5,4297,10
Glenn,3/29/2021,58,10992,19,36,3,44,2942,14,4311,47
Glenn,3/30/2021,73,11065,41,31,1,42,2956,29,4340,43
Glenn,3/31/2021,125,11190,35,89,1,54,2941,70,4410,55
Glenn,4/1/2021,637,11827,182,446,9,226,2767,409,4819,235
Glenn,4/2/2021,158,11985,25,121,12,122,2865,36,4855,134
Glenn,4/3/2021,91,12076,4,80,7,80,2941,11,4866,87
Glenn,4/4/2021,8,12084,3,3,2,4,2943,4,4870,6
Glenn,4/5/2021,65,12149,25,27,13,28,2947,37,4907,41
Glenn,4/6/2021,143,12292,52,52,39,37,2917,105,5012,75
Glenn,4/7/2021,159,12451,46,59,54,73,2958,86,5098,127
Glenn,4/8/2021,638,13089,188,416,34,137,2630,499,5597,171
Glenn,4/9/2021,158,13247,58,84,16,101,2690,57,5654,117
Glenn,4/10/2021,75,13322,1,63,11,63,2752,12,5666,74
Glenn,4/11/2021,17,13339,8,4,5,7,2754,10,5676,12
Glenn,4/12/2021,114,13453,24,61,29,20,2709,94,5770,49
Glenn,4/13/2021,117,13570,63,54,0,31,2655,85,5855,31
Glenn,4/14/2021,120,13690,45,75,0,66,2667,54,5909,66
Glenn,4/15/2021,360,14050,274,86,0,124,2555,236,6145,124
Glenn,4/16/2021,162,14212,38,124,0,81,2555,81,6226,81
Glenn,4/17/2021,163,14375,16,147,0,35,2468,122,6348,35
Glenn,4/18/2021,16,14391,3,13,0,13,2478,3,6351,13
Glenn,4/19/2021,82,14473,17,65,0,27,2451,54,6405,27
Glenn,4/20/2021,125,14598,81,44,0,56,2438,69,6474,56
Glenn,4/21/2021,407,15005,304,103,0,282,2595,125,6599,282
Glenn,4/22/2021,204,15209,46,158,0,42,2476,161,6760,42
Glenn,4/23/2021,147,15356,8,139,0,37,2404,109,6869,37
Humboldt,12/15/2020,2,2,2,0,0,2,2,0,0,2
Humboldt,12/16/2020,15,17,15,0,0,15,17,0,0,15
Humboldt,12/17/2020,117,134,117,0,0,117,134,0,0,117
Humboldt,12/18/2020,176,310,176,0,0,176,310,0,0,176
Humboldt,12/19/2020,10,320,10,0,0,10,320,0,0,10
Humboldt,12/20/2020,28,348,28,0,0,28,348,0,0,28
Humboldt,12/21/2020,165,513,165,0,0,165,513,0,0,165
Humboldt,12/22/2020,293,806,293,0,0,293,806,0,0,293
Humboldt,12/23/2020,310,1116,262,48,0,311,1117,0,0,311
Humboldt,12/24/2020,25,1141,2,23,0,25,1142,0,0,25
Humboldt,12/25/2020,2,1143,2,0,0,2,1144,0,0,2
Humboldt,12/26/2020,6,1149,5,1,0,6,1150,0,0,6
Humboldt,12/28/2020,154,1303,144,10,0,154,1304,0,0,154
Humboldt,12/29/2020,167,1470,124,43,0,167,1471,0,0,167
Humboldt,12/30/2020,223,1693,124,99,0,223,1694,0,0,223
Humboldt,12/31/2020,242,1935,79,163,0,242,1936,0,0,242
Humboldt,1/1/2021,2,1937,1,1,0,2,1938,0,0,2
Humboldt,1/2/2021,38,1975,1,37,0,38,1976,0,0,38
Humboldt,1/4/2021,217,2192,142,75,0,218,2194,0,0,218
Humboldt,1/5/2021,128,2320,18,110,0,127,2320,1,1,127
Humboldt,1/6/2021,302,2622,203,99,0,230,2489,61,62,230
Humboldt,1/7/2021,417,3039,305,112,0,304,2695,98,160,304
Humboldt,1/8/2021,419,3458,279,140,0,284,2848,131,291,284
Humboldt,1/9/2021,69,3527,45,24,0,66,2912,3,294,67
Humboldt,1/10/2021,84,3611,84,0,0,4,2836,80,374,4
Humboldt,1/11/2021,287,3898,276,11,0,72,2697,211,585,72
Humboldt,1/12/2021,480,4378,317,163,0,298,2835,160,745,298
Humboldt,1/13/2021,480,4858,274,206,0,303,2965,174,919,304
Humboldt,1/14/2021,518,5376,161,357,0,462,3372,56,975,463
Humboldt,1/15/2021,374,5750,39,335,0,357,3712,17,992,357
Humboldt,1/16/2021,170,5920,6,164,0,169,3880,1,993,169
Humboldt,1/17/2021,6,5926,4,2,0,6,3886,0,993,6
Humboldt,1/18/2021,292,6218,257,35,0,143,3880,149,1142,143
Humboldt,1/19/2021,626,6844,372,254,0,499,4258,121,1263,499
Humboldt,1/20/2021,911,7755,401,510,0,763,4884,139,1402,765
Humboldt,1/21/2021,956,8711,260,696,0,915,5758,41,1443,915
Humboldt,1/22/2021,675,9386,376,299,0,667,6417,8,1451,667
Humboldt,1/23/2021,800,10186,271,529,0,791,7200,9,1460,792
Humboldt,1/24/2021,226,10412,1,225,0,225,7424,1,1461,225
Humboldt,1/25/2021,303,10715,232,71,0,149,7419,154,1615,149
Humboldt,1/26/2021,526,11241,141,385,0,479,7851,47,1662,479
Humboldt,1/27/2021,1258,12499,585,673,0,1193,8987,58,1720,1194
Humboldt,1/28/2021,1448,13947,627,821,0,1313,10170,132,1852,1315
Humboldt,1/29/2021,1128,15075,543,585,0,710,10463,418,2270,711
Humboldt,1/30/2021,972,16047,458,514,0,961,11414,11,2281,962
Humboldt,1/31/2021,310,16357,309,1,0,309,11722,1,2282,309
Humboldt,2/1/2021,333,16690,192,141,0,189,11768,143,2425,189
Humboldt,2/2/2021,442,17132,73,369,0,339,12008,101,2526,341
Humboldt,2/3/2021,652,17784,259,393,0,502,12360,150,2676,502
Humboldt,2/4/2021,638,18422,262,376,0,442,12609,193,2869,442
Humboldt,2/5/2021,810,19232,94,716,0,624,13047,186,3055,624
Humboldt,2/6/2021,1053,20285,443,610,0,1012,14020,40,3095,1013
Humboldt,2/7/2021,377,20662,7,370,0,373,14390,4,3099,374
Humboldt,2/8/2021,325,20987,142,183,0,184,14434,140,3239,184
Humboldt,2/9/2021,493,21480,218,275,0,178,14297,315,3554,178
Humboldt,2/10/2021,562,22042,369,193,0,232,14204,325,3879,232
Humboldt,2/11/2021,1291,23333,392,899,0,510,13936,778,4657,510
Humboldt,2/12/2021,1145,24478,733,412,0,705,14201,440,5097,705
Humboldt,2/13/2021,1499,25977,552,947,0,911,14526,586,5683,911
Humboldt,2/14/2021,112,26089,5,107,0,109,14633,2,5685,109
Humboldt,2/15/2021,293,26382,78,215,0,196,14732,97,5782,196
Humboldt,2/16/2021,534,26916,117,417,0,252,14703,282,6064,253
Humboldt,2/17/2021,452,27368,280,172,0,137,14525,315,6379,137
Humboldt,2/18/2021,967,28335,596,371,0,230,14019,736,7115,230
Humboldt,2/19/2021,476,28811,435,41,0,90,13726,383,7498,90
Humboldt,2/20/2021,1584,30395,978,606,0,475,13097,1106,8604,477
Humboldt,2/21/2021,480,30875,472,8,0,184,12986,296,8900,185
Humboldt,2/22/2021,125,31000,91,34,0,26,12915,97,8997,26
Humboldt,2/23/2021,173,31173,70,103,0,40,12824,131,9128,40
Humboldt,2/24/2021,1145,32318,687,458,0,568,12816,576,9704,568
Humboldt,2/25/2021,829,33147,315,514,0,227,12443,600,10304,227
Humboldt,2/26/2021,2142,35289,106,2036,0,455,11217,1681,11985,455
Humboldt,2/27/2021,1687,36976,1072,615,0,867,11270,818,12803,871
Humboldt,2/28/2021,122,37098,11,111,0,117,11382,5,12808,117
Humboldt,3/1/2021,255,37353,47,208,0,180,11487,75,12883,180
Humboldt,3/2/2021,286,37639,48,238,0,156,11513,130,13013,156
Humboldt,3/3/2021,1643,39282,1095,548,0,1220,12317,417,13430,1221
Humboldt,3/4/2021,882,40164,107,775,0,266,11969,616,14046,268
Humboldt,3/5/2021,928,41092,181,736,11,375,11806,549,14595,386
Humboldt,3/6/2021,1687,42779,837,801,49,709,11587,977,15572,758
Humboldt,3/7/2021,363,43142,295,50,18,158,11558,205,15777,176
Humboldt,3/8/2021,257,43399,6,173,78,163,11705,94,15871,241
Humboldt,3/9/2021,457,43856,201,111,145,213,11821,242,16113,358
Humboldt,3/10/2021,681,44537,466,62,153,412,12116,268,16381,563
Humboldt,3/11/2021,1370,45907,461,809,100,553,11953,815,17196,652
Humboldt,3/12/2021,1736,47643,1082,434,220,1047,12541,681,17877,1269
Humboldt,3/13/2021,1568,49211,1021,495,52,679,12389,883,18760,731
Humboldt,3/14/2021,139,49350,18,112,9,25,12309,114,18874,34
Humboldt,3/15/2021,268,49618,51,197,20,51,12163,217,19091,71
Humboldt,3/16/2021,632,50250,200,172,260,258,12306,373,19464,516
Humboldt,3/17/2021,728,50978,397,223,108,335,12357,392,19856,443
Humboldt,3/18/2021,1729,52707,1164,522,43,1037,12750,687,20543,1080
Humboldt,3/19/2021,1073,53780,58,701,314,441,12876,629,21172,755
Humboldt,3/20/2021,1372,55152,750,609,13,426,12372,944,22116,440
Humboldt,3/21/2021,246,55398,33,184,29,199,12553,47,22163,228
Humboldt,3/22/2021,111,55509,15,47,49,56,12604,54,22217,105
Humboldt,3/23/2021,408,55917,40,325,43,318,12877,88,22305,361
Humboldt,3/24/2021,1412,57329,389,976,47,1038,13594,366,22671,1083
Humboldt,3/25/2021,1827,59156,1202,563,62,944,13719,881,23552,1006
Humboldt,3/26/2021,2023,61179,425,1543,55,1582,14920,436,23988,1637
Humboldt,3/27/2021,1922,63101,1436,318,168,1058,15286,860,24848,1226
Humboldt,3/28/2021,265,63366,79,115,71,83,15259,182,25030,155
Humboldt,3/29/2021,465,63831,124,246,95,197,15283,267,25297,291
Humboldt,3/30/2021,931,64762,300,517,114,557,15583,370,25667,670
Humboldt,3/31/2021,1846,66608,515,1235,96,1395,16628,448,26115,1493
Humboldt,4/1/2021,2084,68692,694,1301,89,1473,17586,604,26719,1562
Humboldt,4/2/2021,1687,70379,1100,484,103,598,17203,1084,27803,701
Humboldt,4/3/2021,1646,72025,1491,139,16,668,16919,968,28771,684
Humboldt,4/4/2021,470,72495,360,101,9,397,17253,73,28844,407
Humboldt,4/5/2021,755,73250,454,253,48,436,17420,317,29161,484
Humboldt,4/6/2021,811,74061,310,367,134,575,17898,230,29391,708
Humboldt,4/7/2021,1475,75536,1054,283,138,983,18529,490,29881,1121
Humboldt,4/8/2021,1592,77128,1058,410,124,705,18472,886,30767,829
Humboldt,4/9/2021,1405,78533,431,824,150,1132,19476,273,31040,1277
Humboldt,4/10/2021,922,79455,134,614,174,727,20182,194,31234,900
Humboldt,4/11/2021,632,80087,136,30,466,125,20265,507,31741,590
Humboldt,4/12/2021,410,80497,222,75,113,273,20514,137,31878,386
Humboldt,4/13/2021,580,81077,321,256,3,545,21029,32,31910,547
Humboldt,4/14/2021,1408,82485,1029,379,0,1308,22238,99,32009,1308
Humboldt,4/15/2021,1796,84281,1194,598,4,1238,22938,540,32549,1240
Humboldt,4/16/2021,1098,85379,495,603,0,534,22911,561,33110,534
Humboldt,4/17/2021,1549,86928,1229,320,0,1010,23387,534,33644,1010
Humboldt,4/18/2021,470,87398,341,129,0,92,23105,374,34018,92
Humboldt,4/19/2021,144,87542,54,90,0,64,23089,80,34098,64
Humboldt,4/20/2021,435,87977,97,338,0,218,23090,217,34315,218
Humboldt,4/21/2021,989,88966,338,651,0,390,22891,590,34905,391
Humboldt,4/22/2021,815,89781,502,311,2,420,22919,393,35298,421
Humboldt,4/23/2021,644,90425,25,619,0,186,22649,456,35754,186
Imperial,12/16/2020,1,1,1,0,0,1,1,0,0,1
Imperial,12/17/2020,4,5,4,0,0,4,5,0,0,4
Imperial,12/18/2020,11,16,11,0,0,11,16,0,0,11
Imperial,12/20/2020,2,18,2,0,0,2,18,0,0,2
Imperial,12/21/2020,186,204,186,0,0,186,204,0,0,186
Imperial,12/22/2020,241,445,239,2,0,241,445,0,0,241
Imperial,12/23/2020,211,656,210,1,0,210,655,0,0,210
Imperial,12/24/2020,5,661,5,0,0,5,660,0,0,5
Imperial,12/26/2020,1,662,0,1,0,1,661,0,0,1
Imperial,12/27/2020,62,724,0,62,0,62,723,0,0,62
Imperial,12/28/2020,214,938,114,100,0,214,937,0,0,214
Imperial,12/29/2020,189,1127,36,153,0,189,1126,0,0,189
Imperial,12/30/2020,366,1493,50,316,0,366,1492,0,0,366
Imperial,12/31/2020,197,1690,26,171,0,197,1689,0,0,197
Imperial,1/1/2021,46,1736,5,41,0,46,1735,0,0,46
Imperial,1/2/2021,4,1740,0,4,0,4,1739,0,0,4
Imperial,1/3/2021,90,1830,0,90,0,90,1829,0,0,90
Imperial,1/4/2021,85,1915,5,80,0,85,1914,0,0,85
Imperial,1/5/2021,172,2087,13,159,0,172,2086,0,0,172
Imperial,1/6/2021,190,2277,25,165,0,189,2274,1,1,189
Imperial,1/7/2021,319,2596,9,310,0,316,2587,3,4,316
Imperial,1/8/2021,190,2786,50,140,0,181,2759,9,13,181
Imperial,1/9/2021,24,2810,21,3,0,24,2783,0,13,24
Imperial,1/10/2021,1,2811,0,1,0,1,2784,0,13,1
Imperial,1/11/2021,403,3214,244,159,0,175,2731,228,241,175
Imperial,1/12/2021,403,3617,301,102,0,141,2611,261,502,141
Imperial,1/13/2021,379,3996,132,247,0,280,2792,99,601,280
Imperial,1/14/2021,260,4256,151,109,0,254,3041,5,606,254
Imperial,1/15/2021,240,4496,182,58,0,233,3267,7,613,233
Imperial,1/16/2021,76,4572,72,4,0,75,3341,1,614,75
Imperial,1/17/2021,10,4582,2,8,0,10,3351,0,614,10
Imperial,1/18/2021,1056,5638,401,655,0,957,4210,99,713,958
Imperial,1/19/2021,164,5802,128,36,0,117,4280,47,760,117
Imperial,1/20/2021,292,6094,195,97,0,254,4496,38,798,254
Imperial,1/21/2021,415,6509,183,232,0,395,4871,20,818,395
Imperial,1/22/2021,456,6965,189,267,0,447,5309,9,827,447
Imperial,1/23/2021,1041,8006,290,751,0,1040,6348,1,828,1040
Imperial,1/24/2021,10,8016,3,7,0,10,6358,0,828,10
Imperial,1/25/2021,213,8229,5,208,0,34,6214,178,1006,34
Imperial,1/26/2021,359,8588,184,175,0,216,6287,143,1149,216
Imperial,1/27/2021,570,9158,162,408,0,237,6191,333,1482,237
Imperial,1/28/2021,632,9790,159,473,0,525,6609,107,1589,525
Imperial,1/29/2021,423,10213,296,127,0,373,6932,50,1639,373
Imperial,1/30/2021,56,10269,31,25,0,39,6954,17,1656,39
Imperial,1/31/2021,16,10285,6,10,0,15,6968,1,1657,15
Imperial,2/1/2021,419,10704,53,366,0,208,6967,209,1866,208
Imperial,2/2/2021,679,11383,54,625,0,498,7284,181,2047,498
Imperial,2/3/2021,456,11839,47,409,0,263,7355,192,2239,263
Imperial,2/4/2021,1716,13555,1197,519,0,1402,8445,312,2551,1402
Imperial,2/5/2021,389,13944,241,148,0,153,8364,234,2785,153
Imperial,2/6/2021,861,14805,838,23,0,824,9152,36,2821,824
Imperial,2/7/2021,21,14826,9,12,0,20,9171,1,2822,20
Imperial,2/8/2021,250,15076,42,208,0,182,9285,68,2890,182
Imperial,2/9/2021,461,15537,145,316,0,304,9432,157,3047,304
Imperial,2/10/2021,384,15921,56,328,0,94,9237,290,3337,95
Imperial,2/11/2021,462,16383,258,204,0,89,8953,373,3710,89
Imperial,2/12/2021,2129,18512,1411,718,0,1777,10379,351,4061,1777
Imperial,2/13/2021,42,18554,18,24,0,34,10406,8,4069,35
Imperial,2/14/2021,23,18577,11,12,0,21,10425,2,4071,21
Imperial,2/15/2021,30,18607,10,20,0,23,10441,7,4078,23
Imperial,2/16/2021,514,19121,266,248,0,293,10513,221,4299,293
Imperial,2/17/2021,439,19560,285,154,0,83,10240,356,4655,83
Imperial,2/18/2021,646,20206,308,338,0,140,9876,504,5159,140
Imperial,2/19/2021,766,20972,381,385,0,192,9495,573,5732,192
Imperial,2/20/2021,1039,22011,191,848,0,325,9109,713,6445,327
Imperial,2/21/2021,588,22599,554,34,0,577,9676,10,6455,577
Imperial,2/22/2021,809,23408,569,240,0,759,10385,50,6505,759
Imperial,2/23/2021,937,24345,372,565,0,887,11222,50,6555,887
Imperial,2/24/2021,700,25045,285,415,0,602,11727,97,6652,602
Imperial,2/25/2021,815,25860,338,477,0,449,11816,365,7017,454
Imperial,2/26/2021,1743,27603,1350,393,0,1569,13213,172,7189,1569
Imperial,2/27/2021,858,28461,809,49,0,120,12596,738,7927,121
Imperial,2/28/2021,29,28490,19,10,0,20,12607,9,7936,20
Imperial,3/1/2021,492,28982,293,198,1,427,12973,63,7999,429
Imperial,3/2/2021,673,29655,246,427,0,384,13070,289,8288,386
Imperial,3/3/2021,915,30570,39,875,1,546,13262,366,8654,558
Imperial,3/4/2021,745,31315,76,668,1,485,13519,258,8912,515
Imperial,3/5/2021,2568,33883,1937,631,0,1243,13442,1322,10234,1245
Imperial,3/6/2021,688,34571,236,452,0,647,14055,38,10272,651
Imperial,3/7/2021,72,34643,39,33,0,52,14088,20,10292,53
Imperial,3/8/2021,412,35055,329,48,35,360,14431,52,10344,395
Imperial,3/9/2021,681,35736,310,125,246,397,14790,284,10628,643
Imperial,3/10/2021,681,36417,312,266,103,318,14850,362,10990,422
Imperial,3/11/2021,1787,38204,478,1116,193,1186,15640,600,11590,1390
Imperial,3/12/2021,3699,41903,2538,976,185,2101,16331,1596,13186,2287
Imperial,3/13/2021,1141,43044,90,828,223,856,17130,283,13469,1082
Imperial,3/14/2021,168,43212,30,126,12,138,17251,30,13499,151
Imperial,3/15/2021,669,43881,214,197,258,374,17589,294,13793,632
Imperial,3/16/2021,1069,44950,276,340,453,532,18039,535,14328,985
Imperial,3/17/2021,1572,46522,691,744,137,994,18596,575,14903,1132
Imperial,3/18/2021,1779,48301,1176,543,60,1250,19381,527,15430,1312
Imperial,3/19/2021,3335,51636,2445,886,4,1499,19056,1829,17259,1504
Imperial,3/20/2021,862,52498,550,307,5,418,19045,440,17699,429
Imperial,3/21/2021,214,52712,33,177,4,156,19151,58,17757,164
Imperial,3/22/2021,1044,53756,338,699,7,623,19362,420,18177,631
Imperial,3/23/2021,1388,55144,410,972,6,889,19762,497,18674,897
Imperial,3/24/2021,1870,57014,542,901,427,899,20120,969,19643,1327
Imperial,3/25/2021,2795,59809,500,874,1421,1003,20752,1788,21431,2420
Imperial,3/26/2021,2475,62284,875,730,870,770,20694,1699,23130,1641
Imperial,3/27/2021,576,62860,264,260,52,417,21007,156,23286,469
Imperial,3/28/2021,209,63069,51,156,2,172,21145,36,23322,174
Imperial,3/29/2021,1172,64241,345,390,437,313,21039,857,24179,751
Imperial,3/30/2021,1771,66012,676,591,504,675,21123,1096,25275,1180
Imperial,3/31/2021,1531,67543,715,811,5,1021,21640,508,25783,1025
Imperial,4/1/2021,1799,69342,396,1162,241,808,21702,987,26770,1049
Imperial,4/2/2021,1250,70592,445,731,74,736,21999,512,27282,809
Imperial,4/3/2021,1490,72082,405,1007,78,684,21959,802,28084,762
Imperial,4/4/2021,83,72165,39,28,16,24,21940,59,28143,40
Imperial,4/5/2021,2108,74273,1278,763,67,400,20707,1701,29844,468
Imperial,4/6/2021,1291,75564,528,574,189,680,20969,608,30452,870
Imperial,4/7/2021,2148,77712,549,1224,375,1539,22278,605,31057,1914
Imperial,4/8/2021,2182,79894,1068,822,292,1075,22540,1104,32161,1366
Imperial,4/9/2021,2133,82027,627,891,615,828,22682,1301,33462,1443
Imperial,4/10/2021,1268,83295,182,816,270,209,22102,1057,34519,477
Imperial,4/11/2021,215,83510,29,154,32,73,22065,142,34661,105
Imperial,4/12/2021,1330,84840,761,380,189,744,22418,583,35244,936
Imperial,4/13/2021,2210,87050,1442,767,1,1532,23278,673,35917,1533
Imperial,4/14/2021,1896,88946,941,955,0,1331,24050,560,36477,1332
Imperial,4/15/2021,1814,90760,873,941,0,1315,24869,497,36974,1316
Imperial,4/16/2021,2022,92782,961,1061,0,1153,25157,865,37839,1153
Imperial,4/17/2021,1721,94503,852,867,2,1356,26155,361,38200,1359
Imperial,4/18/2021,244,94747,63,181,0,85,26082,158,38358,85
Imperial,4/19/2021,754,95501,247,507,0,441,26215,312,38670,445
Imperial,4/20/2021,1257,96758,510,747,0,736,26433,518,39188,736
Imperial,4/21/2021,1262,98020,324,938,0,776,26726,483,39671,776
Imperial,4/22/2021,1641,99661,759,882,0,1149,27391,486,40157,1151
Imperial,4/23/2021,1123,100784,345,778,0,726,27731,390,40547,730
Inyo,12/19/2020,85,85,85,0,0,85,85,0,0,85
Inyo,12/20/2020,58,143,58,0,0,58,143,0,0,58
Inyo,12/21/2020,88,231,85,3,0,88,231,0,0,88
Inyo,12/22/2020,105,336,105,0,0,105,336,0,0,105
Inyo,12/23/2020,70,406,67,3,0,70,406,0,0,70
Inyo,12/24/2020,16,422,16,0,0,16,422,0,0,16
Inyo,12/25/2020,1,423,0,1,0,1,423,0,0,1
Inyo,12/26/2020,74,497,74,0,0,74,497,0,0,74
Inyo,12/28/2020,48,545,36,12,0,48,545,0,0,48
Inyo,12/29/2020,20,565,20,0,0,20,565,0,0,20
Inyo,12/30/2020,56,621,54,2,0,56,621,0,0,56
Inyo,12/31/2020,29,650,0,29,0,29,650,0,0,29
Inyo,1/1/2021,1,651,0,1,0,1,651,0,0,1
Inyo,1/3/2021,1,652,0,1,0,1,652,0,0,1
Inyo,1/4/2021,1,653,1,0,0,1,653,0,0,1
Inyo,1/5/2021,34,687,0,34,0,34,687,0,0,34
Inyo,1/6/2021,68,755,0,68,0,68,755,0,0,68
Inyo,1/7/2021,31,786,1,30,0,31,786,0,0,31
Inyo,1/8/2021,9,795,8,1,0,4,786,5,5,5
Inyo,1/9/2021,87,882,86,1,0,1,701,86,91,1
Inyo,1/10/2021,52,934,52,0,0,0,649,52,143,0
Inyo,1/11/2021,97,1031,82,15,0,16,584,81,224,16
Inyo,1/12/2021,139,1170,118,21,0,28,501,111,335,28
Inyo,1/13/2021,86,1256,68,18,0,21,458,65,400,22
Inyo,1/14/2021,59,1315,13,46,0,49,497,10,410,49
Inyo,1/15/2021,163,1478,28,135,0,163,660,0,410,163
Inyo,1/16/2021,74,1552,73,1,0,1,588,73,483,1
Inyo,1/18/2021,58,1610,36,22,0,19,568,39,522,19
Inyo,1/19/2021,115,1725,72,43,0,99,651,16,538,99
Inyo,1/20/2021,145,1870,70,75,0,91,688,54,592,91
Inyo,1/21/2021,121,1991,57,64,0,120,807,1,593,120
Inyo,1/22/2021,62,2053,0,62,0,61,867,1,594,61
Inyo,1/23/2021,52,2105,52,0,0,52,919,0,594,52
Inyo,1/25/2021,49,2154,6,43,0,37,944,12,606,37
Inyo,1/26/2021,135,2289,54,81,0,129,1067,6,612,129
Inyo,1/27/2021,23,2312,2,21,0,22,1088,1,613,22
Inyo,1/28/2021,92,2404,2,90,0,63,1122,29,642,63
Inyo,1/29/2021,25,2429,3,22,0,23,1143,2,644,23
Inyo,1/30/2021,11,2440,1,10,0,11,1154,0,644,11
Inyo,1/31/2021,32,2472,4,28,0,4,1130,28,672,4
Inyo,2/1/2021,11,2483,9,2,0,1,1121,10,682,1
Inyo,2/2/2021,130,2613,14,116,0,104,1199,26,708,104
Inyo,2/3/2021,116,2729,0,116,0,74,1231,42,750,74
Inyo,2/4/2021,149,2878,31,118,0,90,1262,59,809,90
Inyo,2/5/2021,117,2995,61,56,0,115,1375,2,811,115
Inyo,2/6/2021,4,2999,2,2,0,3,1377,1,812,3
Inyo,2/7/2021,4,3003,2,2,0,4,1381,0,812,4
Inyo,2/8/2021,117,3120,7,110,0,97,1458,20,832,97
Inyo,2/9/2021,194,3314,51,143,0,123,1510,71,903,123
Inyo,2/10/2021,143,3457,18,125,0,109,1585,34,937,109
Inyo,2/11/2021,220,3677,56,164,0,126,1617,94,1031,126
Inyo,2/12/2021,299,3976,52,247,0,168,1654,131,1162,168
Inyo,2/13/2021,60,4036,55,5,0,8,1610,52,1214,8
Inyo,2/14/2021,1,4037,0,1,0,1,1611,0,1214,1
Inyo,2/15/2021,29,4066,9,20,0,5,1592,24,1238,5
Inyo,2/16/2021,181,4247,50,131,0,93,1597,88,1326,93
Inyo,2/17/2021,37,4284,4,33,0,7,1574,30,1356,7
Inyo,2/18/2021,123,4407,6,117,0,79,1609,44,1400,79
Inyo,2/19/2021,52,4459,4,48,0,9,1575,43,1443,9
Inyo,2/20/2021,504,4963,500,4,0,502,2075,2,1445,502
Inyo,2/21/2021,267,5230,267,0,0,267,2342,0,1445,267
Inyo,2/22/2021,61,5291,19,42,0,27,2335,34,1479,27
Inyo,2/23/2021,198,5489,20,178,0,94,2326,103,1582,94
Inyo,2/24/2021,116,5605,0,116,0,57,2324,59,1641,57
Inyo,2/25/2021,130,5735,3,127,0,62,2318,68,1709,62
Inyo,2/26/2021,103,5838,60,43,0,19,2253,84,1793,19
Inyo,2/27/2021,15,5853,4,11,0,3,2244,12,1805,3
Inyo,2/28/2021,3,5856,1,2,0,2,2245,1,1806,2
Inyo,3/1/2021,20,5876,2,18,0,17,2259,3,1809,17
Inyo,3/2/2021,195,6071,1,194,0,111,2286,84,1893,111
Inyo,3/3/2021,83,6154,2,81,0,40,2283,43,1936,40
Inyo,3/4/2021,128,6282,4,124,0,46,2247,82,2018,46
Inyo,3/5/2021,142,6424,57,85,0,38,2181,104,2122,38
Inyo,3/6/2021,31,6455,1,30,0,30,2210,1,2123,30
Inyo,3/7/2021,7,6462,4,3,0,5,2213,2,2125,5
Inyo,3/8/2021,182,6644,5,177,0,91,2213,91,2216,91
Inyo,3/9/2021,186,6830,2,184,0,71,2169,115,2331,71
Inyo,3/10/2021,70,6900,8,61,1,30,2160,40,2371,31
Inyo,3/11/2021,203,7103,1,197,5,73,2108,130,2501,78
Inyo,3/12/2021,174,7277,4,165,5,76,2091,98,2599,81
Inyo,3/13/2021,576,7853,541,25,10,77,1680,498,3097,87
Inyo,3/14/2021,432,8285,430,2,0,169,1587,262,3359,169
Inyo,3/15/2021,51,8336,15,34,2,30,1598,21,3380,32
Inyo,3/16/2021,164,8500,4,154,6,63,1567,100,3480,69
Inyo,3/17/2021,107,8607,3,97,7,92,1651,15,3495,99
Inyo,3/18/2021,182,8789,14,161,7,102,1680,80,3575,109
Inyo,3/19/2021,45,8834,4,37,4,35,1709,10,3585,39
Inyo,3/20/2021,20,8854,1,10,9,1,1700,19,3604,10
Inyo,3/22/2021,59,8913,2,52,5,39,1724,20,3624,44
Inyo,3/23/2021,195,9108,4,187,4,105,1743,90,3714,109
Inyo,3/24/2021,140,9248,2,134,4,87,1781,53,3767,91
Inyo,3/25/2021,325,9573,104,217,4,259,1978,66,3833,263
Inyo,3/26/2021,90,9663,2,84,4,70,2032,20,3853,74
Inyo,3/27/2021,52,9715,44,5,3,46,2075,6,3859,49
Inyo,3/28/2021,4,9719,1,2,1,1,2074,3,3862,2
Inyo,3/29/2021,109,9828,2,102,5,82,2135,26,3888,87
Inyo,3/30/2021,212,10040,3,204,5,102,2132,110,3998,107
Inyo,3/31/2021,144,10184,4,135,5,103,2199,41,4039,108
Inyo,4/1/2021,164,10348,4,159,1,115,2266,49,4088,116
Inyo,4/2/2021,81,10429,1,78,2,52,2291,29,4117,54
Inyo,4/3/2021,93,10522,46,33,14,5,2223,86,4203,18
Inyo,4/4/2021,5,10527,4,0,1,1,2221,4,4207,2
Inyo,4/5/2021,117,10644,1,112,4,29,2166,88,4295,33
Inyo,4/6/2021,235,10879,6,166,63,104,2202,131,4426,167
Inyo,4/7/2021,200,11079,3,71,126,44,2216,156,4582,170
Inyo,4/8/2021,176,11255,14,145,17,80,2217,96,4678,97
Inyo,4/9/2021,123,11378,5,95,23,36,2190,86,4764,59
Inyo,4/10/2021,42,11420,1,24,17,3,2171,39,4803,20
Inyo,4/11/2021,1,11421,0,1,0,1,2172,0,4803,1
Inyo,4/12/2021,79,11500,0,74,5,41,2180,38,4841,46
Inyo,4/13/2021,119,11619,3,113,3,61,2187,57,4898,64
Inyo,4/14/2021,121,11740,2,119,0,39,2144,82,4980,39
Inyo,4/15/2021,261,12001,102,159,0,82,2047,179,5159,82
Inyo,4/16/2021,46,12047,5,41,0,21,2043,25,5184,21
Inyo,4/17/2021,2,12049,1,1,0,1,2043,1,5185,1
Inyo,4/19/2021,129,12178,43,86,0,43,2000,86,5271,43
Inyo,4/20/2021,162,12340,3,159,0,80,1998,82,5353,80
Inyo,4/21/2021,114,12454,4,110,0,32,1948,82,5435,32
Inyo,4/22/2021,196,12650,2,194,0,54,1860,142,5577,54
Inyo,4/23/2021,10,12660,4,6,0,8,1866,2,5579,8
Kern,12/15/2020,1,1,1,0,0,1,1,0,0,1
Kern,12/16/2020,18,19,18,0,0,18,19,0,0,18
Kern,12/17/2020,164,183,164,0,0,164,183,0,0,164
Kern,12/18/2020,320,503,320,0,0,320,503,0,0,320
Kern,12/19/2020,98,601,98,0,0,99,602,0,0,99
Kern,12/20/2020,61,662,61,0,0,61,663,0,0,61
Kern,12/21/2020,671,1333,670,1,0,671,1334,0,0,671
Kern,12/22/2020,530,1863,527,3,0,530,1864,0,0,530
Kern,12/23/2020,557,2420,418,139,0,557,2421,0,0,557
Kern,12/24/2020,122,2542,43,79,0,122,2543,0,0,122
Kern,12/25/2020,1,2543,1,0,0,1,2544,0,0,1
Kern,12/26/2020,33,2576,1,32,0,33,2577,0,0,33
Kern,12/27/2020,35,2611,3,32,0,35,2612,0,0,35
Kern,12/28/2020,824,3435,660,164,0,824,3436,0,0,824
Kern,12/29/2020,746,4181,453,293,0,745,4180,1,1,745
Kern,12/30/2020,1200,5381,908,292,0,1200,5380,0,1,1200
Kern,12/31/2020,277,5658,99,178,0,277,5657,0,1,277
Kern,1/1/2021,12,5670,6,6,0,12,5669,0,1,12
Kern,1/2/2021,78,5748,18,60,0,78,5747,0,1,78
Kern,1/3/2021,23,5771,4,19,0,23,5770,0,1,23
Kern,1/4/2021,553,6324,360,193,0,553,6323,0,1,553
Kern,1/5/2021,1132,7456,738,394,0,1120,7431,12,13,1120
Kern,1/6/2021,1166,8622,455,711,0,1136,8537,30,43,1136
Kern,1/7/2021,1406,10028,494,912,0,1237,9606,168,211,1237
Kern,1/8/2021,1628,11656,767,861,0,1331,10640,298,509,1332
Kern,1/9/2021,225,11881,76,149,0,191,10797,34,543,191
Kern,1/10/2021,194,12075,147,47,0,153,10909,41,584,153
Kern,1/11/2021,1555,13630,983,572,0,1000,11354,555,1139,1000
Kern,1/12/2021,1869,15499,809,1060,0,1359,12203,510,1649,1359
Kern,1/13/2021,1855,17354,869,986,0,1433,13214,422,2071,1433
Kern,1/14/2021,2181,19535,645,1536,0,2136,15304,46,2117,2136
Kern,1/15/2021,2702,22237,857,1845,0,2605,17815,95,2212,2606
Kern,1/16/2021,670,22907,212,458,0,636,18417,34,2246,636
Kern,1/17/2021,72,22979,7,65,0,70,18485,2,2248,70
Kern,1/18/2021,1643,24622,658,985,0,1474,19790,169,2417,1474
Kern,1/19/2021,1852,26474,1031,821,0,1384,20707,468,2885,1385
Kern,1/20/2021,2444,28918,1510,934,0,1821,21912,618,3503,1823
Kern,1/21/2021,2163,31081,919,1244,0,1967,23684,195,3698,1967
Kern,1/22/2021,2706,33787,1289,1417,0,2430,25840,274,3972,2430
Kern,1/23/2021,1245,35032,534,711,0,1199,26993,46,4018,1199
Kern,1/24/2021,159,35191,18,141,0,154,27142,5,4023,154
Kern,1/25/2021,2383,37574,1084,1299,0,1900,28561,482,4505,1901
Kern,1/26/2021,2764,40338,1125,1639,0,1908,29614,855,5360,1908
Kern,1/27/2021,3557,43895,1902,1655,0,2857,31774,697,6057,2857
Kern,1/28/2021,2860,46755,1351,1509,0,2428,33777,428,6485,2431
Kern,1/29/2021,3766,50521,1801,1965,0,3224,36462,539,7024,3224
Kern,1/30/2021,1323,51844,496,827,0,1276,37693,45,7069,1276
Kern,1/31/2021,402,52246,275,127,0,267,37825,135,7204,267
Kern,2/1/2021,2407,54653,818,1589,0,1857,39136,547,7751,1858
Kern,2/2/2021,2922,57575,973,1949,0,2059,40333,863,8614,2060
Kern,2/3/2021,3652,61227,1548,2104,0,2686,42060,959,9573,2686
Kern,2/4/2021,3800,65027,1450,2350,0,2585,43441,1204,10777,2585
Kern,2/5/2021,4849,69876,1990,2859,0,3091,44793,1739,12516,3091
Kern,2/6/2021,1735,71611,766,969,0,1512,46085,220,12736,1512
Kern,2/7/2021,282,71893,149,133,0,266,46337,14,12750,266
Kern,2/8/2021,2562,74455,788,1774,0,1257,46308,1287,14037,1258
Kern,2/9/2021,3036,77491,985,2051,0,1466,46211,1563,15600,1466
Kern,2/10/2021,3782,81273,1656,2126,0,1895,46236,1871,17471,1896
Kern,2/11/2021,4257,85530,1538,2719,0,2229,46450,2015,19486,2229
Kern,2/12/2021,4947,90477,1890,3057,0,2482,46481,2451,21937,2482
Kern,2/13/2021,2009,92486,726,1283,0,1166,46806,841,22778,1166
Kern,2/14/2021,349,92835,12,337,0,269,46996,79,22857,269
Kern,2/15/2021,2738,95573,889,1849,0,1209,46684,1521,24378,1209
Kern,2/16/2021,2946,98519,719,2227,0,1656,47061,1280,25658,1657
Kern,2/17/2021,4063,102582,2074,1989,0,1929,46862,2129,27787,1930
Kern,2/18/2021,3749,106331,1476,2273,0,1618,46362,2118,29905,1618
Kern,2/19/2021,4195,110526,1916,2279,0,1739,45653,2448,32353,1739
Kern,2/20/2021,2572,113098,968,1604,0,1340,45764,1229,33582,1340
Kern,2/21/2021,247,113345,141,106,0,86,45691,159,33741,86
Kern,2/22/2021,2655,116000,1148,1507,0,1424,45889,1226,34967,1424
Kern,2/23/2021,3537,119537,1119,2418,0,1975,46305,1560,36527,1976
Kern,2/24/2021,5155,124692,2265,2890,0,3073,47300,2078,38605,3073
Kern,2/25/2021,5351,130043,2445,2906,0,3175,48317,2158,40763,3175
Kern,2/26/2021,6882,136925,3518,3364,0,4356,50155,2519,43282,4357
Kern,2/27/2021,3852,140777,1892,1960,0,2518,51346,1327,44609,2518
Kern,2/28/2021,905,141682,497,408,0,689,51821,214,44823,689
Kern,3/1/2021,3981,145663,1804,2176,1,2690,53229,1283,46106,2691
Kern,3/2/2021,4366,150029,1372,2993,1,2863,54600,1492,47598,2863
Kern,3/3/2021,5763,155792,2681,3082,0,3677,56206,2072,49670,3678
Kern,3/4/2021,5529,161321,2140,3387,2,3541,57773,1975,51645,3542
Kern,3/5/2021,6455,167776,2664,3774,17,4037,59416,2411,54056,4054
Kern,3/6/2021,4709,172485,1910,2698,101,3445,61705,1256,55312,3545
Kern,3/7/2021,2041,174526,1584,410,47,1852,63416,188,55500,1899
Kern,3/8/2021,2802,177328,851,1738,213,1457,63742,1342,56842,1668
Kern,3/9/2021,3618,180946,784,2451,383,2226,64962,1387,58229,2607
Kern,3/10/2021,6013,186959,2460,2482,1071,3497,67024,2505,60734,4567
Kern,3/11/2021,6275,193234,2400,2849,1026,3725,69234,2539,63273,4749
Kern,3/12/2021,7654,200888,2918,3385,1351,4150,71232,3494,66767,5492
Kern,3/13/2021,4422,205310,2300,1787,335,3004,73152,1413,68180,3333
Kern,3/14/2021,2261,207571,1413,610,238,1747,74622,512,68692,1982
Kern,3/15/2021,4234,211805,1079,2442,713,2172,75454,2050,70742,2882
Kern,3/16/2021,4305,216110,1000,2777,528,2310,76303,1986,72728,2835
Kern,3/17/2021,7215,223325,3795,2863,557,4285,78224,2920,75648,4841
Kern,3/18/2021,6948,230273,3378,2991,579,4127,80124,2803,78451,4703
Kern,3/19/2021,8699,238972,4747,3303,649,4513,81108,4172,82623,5156
Kern,3/20/2021,5934,244906,3587,2174,173,3812,82981,2113,84736,3986
Kern,3/21/2021,2859,247765,1747,235,877,1681,84365,1174,85910,2558
Kern,3/22/2021,3910,251675,1517,2037,356,1898,84615,2004,87914,2254
Kern,3/23/2021,4614,256289,1641,2794,179,2453,85112,2132,90046,2629
Kern,3/24/2021,6965,263254,3498,2994,473,3650,85932,3301,93347,4121
Kern,3/25/2021,6605,269859,2876,3402,327,3279,86226,3311,96658,3605
Kern,3/26/2021,9396,279255,4135,4005,1256,4649,87398,4732,101390,5904
Kern,3/27/2021,5437,284692,3738,1573,126,3302,88695,2131,103521,3428
Kern,3/28/2021,4281,288973,3797,470,14,2736,89901,1544,105065,2750
Kern,3/29/2021,4171,293144,1623,2270,278,2605,91228,1555,106620,2882
Kern,3/30/2021,5412,298556,1804,3302,306,3061,92248,2346,108966,3366
Kern,3/31/2021,8041,306597,4235,3162,644,4283,93425,3749,112715,4926
Kern,4/1/2021,7572,314169,3627,3651,294,4089,94334,3472,116187,4381
Kern,4/2/2021,8112,322281,4181,3327,604,4074,94985,4024,120211,4675
Kern,4/3/2021,5666,327947,3374,2111,181,2579,94667,3076,123287,2758
Kern,4/4/2021,1331,329278,867,380,84,550,94523,778,124065,634
Kern,4/5/2021,5287,334565,2178,2348,761,2847,95700,2429,126494,3606
Kern,4/6/2021,6769,341334,2431,3127,1211,3567,97292,3185,129679,4777
Kern,4/7/2021,9205,350539,5367,2887,951,4629,98309,4562,134241,5579
Kern,4/8/2021,8549,359088,4728,2925,896,3921,98517,4609,138850,4817
Kern,4/9/2021,9791,368879,5079,3731,981,4368,98461,5403,144253,5347
Kern,4/10/2021,6522,375401,3430,1855,1237,2308,97793,4207,148460,3539
Kern,4/11/2021,3761,379162,2888,356,517,1426,97409,2325,150785,1941
Kern,4/12/2021,4301,383463,978,2358,965,1558,97200,2731,153516,2522
Kern,4/13/2021,4209,387672,1408,2776,25,2114,97255,2085,155601,2140
Kern,4/14/2021,5917,393589,2947,2948,22,3036,97447,2865,158466,3057
Kern,4/15/2021,5128,398717,2434,2692,2,2491,97314,2626,161092,2493
Kern,4/16/2021,6720,405437,3399,3321,0,3016,96648,3683,164775,3017
Kern,4/17/2021,5890,411327,3847,2043,0,2256,95283,3622,168397,2257
Kern,4/18/2021,3608,414935,3372,236,0,1067,93814,2536,170933,1067
Kern,4/19/2021,3704,418639,1720,1983,1,1407,92942,2279,173212,1407
Kern,4/20/2021,4179,422818,1503,2675,1,1608,91995,2557,175769,1610
Kern,4/21/2021,5583,428401,2989,2590,4,2184,90802,3380,179149,2187
Kern,4/22/2021,4195,432596,2268,1927,0,1549,89725,2628,181777,1551
Kern,4/23/2021,3680,436276,2470,1210,0,1204,88475,2455,184232,1205
Kings,12/16/2020,1,1,1,0,0,1,1,0,0,1
Kings,12/17/2020,8,9,8,0,0,8,9,0,0,8
Kings,12/18/2020,12,21,12,0,0,12,21,0,0,12
Kings,12/19/2020,11,32,11,0,0,11,32,0,0,11
Kings,12/20/2020,13,45,13,0,0,13,45,0,0,13
Kings,12/21/2020,156,201,156,0,0,271,316,0,0,271
Kings,12/22/2020,143,344,143,0,0,140,456,0,0,140
Kings,12/23/2020,134,478,122,12,0,135,591,0,0,135
Kings,12/24/2020,11,489,9,2,0,11,602,0,0,11
Kings,12/26/2020,7,496,4,3,0,7,609,0,0,7
Kings,12/27/2020,4,500,4,0,0,4,613,0,0,4
Kings,12/28/2020,131,631,103,28,0,132,745,0,0,132
Kings,12/29/2020,78,709,51,27,0,79,824,0,0,79
Kings,12/30/2020,147,856,108,39,0,147,971,0,0,147
Kings,12/31/2020,44,900,6,38,0,44,1015,0,0,44
Kings,1/1/2021,1,901,0,1,0,1,1016,0,0,1
Kings,1/2/2021,10,911,9,1,0,10,1026,0,0,10
Kings,1/4/2021,112,1023,42,70,0,112,1138,0,0,112
Kings,1/5/2021,196,1219,39,157,0,196,1334,0,0,196
Kings,1/6/2021,276,1495,177,99,0,273,1604,3,3,273
Kings,1/7/2021,178,1673,81,97,0,170,1766,8,11,170
Kings,1/8/2021,247,1920,54,193,0,228,1975,19,30,228
Kings,1/9/2021,63,1983,9,54,0,55,2022,8,38,55
Kings,1/10/2021,15,1998,3,12,0,12,2031,3,41,12
Kings,1/11/2021,520,2518,356,164,0,276,2064,244,285,277
Kings,1/12/2021,350,2868,253,97,0,216,2149,131,416,216
Kings,1/13/2021,414,3282,267,147,0,323,2381,91,507,323
Kings,1/14/2021,208,3490,31,177,0,198,2559,21,528,199
Kings,1/15/2021,415,3905,29,386,0,403,2950,12,540,403
Kings,1/16/2021,31,3936,12,19,0,30,2979,1,541,30
Kings,1/17/2021,8,3944,5,3,0,6,2983,2,543,6
Kings,1/18/2021,172,4116,40,132,0,146,3103,26,569,146
Kings,1/19/2021,376,4492,158,218,0,248,3223,128,697,248
Kings,1/20/2021,224,4716,134,90,0,119,3241,101,798,119
Kings,1/21/2021,186,4902,32,154,0,172,3397,16,814,172
Kings,1/22/2021,125,5027,38,87,0,125,3517,5,819,125
Kings,1/23/2021,26,5053,14,12,0,20,3531,6,825,20
Kings,1/24/2021,4,5057,4,0,0,2,3531,2,827,2
Kings,1/25/2021,124,5181,26,98,0,90,3587,34,861,90
Kings,1/26/2021,154,5335,35,119,0,115,3663,39,900,115
Kings,1/27/2021,319,5654,34,285,0,249,3843,69,969,249
Kings,1/28/2021,324,5978,46,278,0,270,4059,54,1023,270
Kings,1/29/2021,86,6064,26,60,0,69,4111,17,1040,69
Kings,1/30/2021,1555,7619,31,1524,0,1552,5662,3,1043,1554
Kings,2/1/2021,199,7818,64,135,0,72,5609,125,1168,72
Kings,2/2/2021,226,8044,14,212,0,82,5548,143,1311,82
Kings,2/3/2021,357,8401,191,166,0,203,5598,153,1464,203
Kings,2/4/2021,395,8796,98,297,0,199,5602,195,1659,199
Kings,2/5/2021,256,9052,14,242,0,101,5550,153,1812,101
Kings,2/6/2021,60,9112,10,50,0,27,5544,33,1845,27
Kings,2/7/2021,5,9117,3,2,0,3,5545,2,1847,3
Kings,2/8/2021,170,9287,29,141,0,68,5511,102,1949,68
Kings,2/9/2021,253,9540,57,196,0,110,5480,141,2090,110
Kings,2/10/2021,286,9826,112,174,0,173,5540,113,2203,173
Kings,2/11/2021,429,10255,65,364,0,318,5748,110,2313,318
Kings,2/12/2021,610,10865,36,574,0,339,5816,271,2584,339
Kings,2/13/2021,103,10968,6,97,0,78,5869,25,2609,78
Kings,2/14/2021,102,11070,4,98,0,94,5955,8,2617,94
Kings,2/15/2021,246,11316,5,241,0,137,5984,108,2725,137
Kings,2/16/2021,484,11800,33,451,0,250,6001,233,2958,250
Kings,2/17/2021,378,12178,22,356,0,241,6106,137,3095,242
Kings,2/18/2021,154,12332,22,132,0,98,6148,56,3151,98
Kings,2/19/2021,157,12489,22,135,0,101,6196,53,3204,101
Kings,2/20/2021,171,12660,40,131,0,134,6293,37,3241,134
Kings,2/21/2021,3,12663,2,1,0,3,6296,0,3241,3
Kings,2/22/2021,110,12773,19,91,0,51,6288,59,3300,51
Kings,2/23/2021,295,13068,69,226,0,178,6349,117,3417,178
Kings,2/24/2021,591,13659,153,438,0,379,6516,212,3629,379
Kings,2/25/2021,661,14320,112,549,0,443,6743,216,3845,443
Kings,2/26/2021,657,14977,129,528,0,594,7275,62,3907,594
Kings,2/27/2021,1497,16474,62,1435,0,564,6907,932,4839,564
Kings,2/28/2021,1169,17643,594,575,0,671,7083,495,5334,671
Kings,3/1/2021,256,17899,77,179,0,211,7249,45,5379,211
Kings,3/2/2021,469,18368,205,264,0,419,7619,50,5429,420
Kings,3/3/2021,617,18985,294,323,0,430,7863,186,5615,430
Kings,3/4/2021,712,19697,341,371,0,617,8386,95,5710,618
Kings,3/5/2021,1006,20703,349,648,9,890,9170,116,5826,900
Kings,3/6/2021,509,21212,183,313,13,480,9634,29,5855,493
Kings,3/7/2021,366,21578,225,137,4,358,9988,8,5863,362
Kings,3/8/2021,349,21927,97,199,53,240,10171,109,5972,292
Kings,3/9/2021,515,22442,238,222,55,410,10532,105,6077,466
Kings,3/10/2021,501,22943,123,287,91,319,10760,181,6258,409
Kings,3/11/2021,1017,23960,305,602,110,612,11079,403,6661,722
Kings,3/12/2021,1286,25246,391,801,94,885,11660,400,7061,981
Kings,3/13/2021,672,25918,332,296,44,545,12123,127,7188,590
Kings,3/14/2021,671,26589,101,184,386,200,12238,471,7659,586
Kings,3/15/2021,627,27216,192,320,115,391,12511,235,7894,508
Kings,3/16/2021,1039,28255,439,539,61,703,12939,336,8230,764
Kings,3/17/2021,1085,29340,415,609,61,768,13458,317,8547,836
Kings,3/18/2021,1098,30438,466,410,222,766,14118,331,8878,991
Kings,3/19/2021,931,31369,468,378,85,714,14713,217,9095,812
Kings,3/20/2021,622,31991,255,337,30,449,15028,171,9266,486
Kings,3/21/2021,1400,33391,1085,304,11,847,15333,553,9819,858
Kings,3/22/2021,449,33840,202,163,84,275,15522,174,9993,363
Kings,3/23/2021,896,34736,492,341,63,575,15844,319,10312,641
Kings,3/24/2021,914,35650,474,417,23,510,15977,402,10714,535
Kings,3/25/2021,884,36534,440,418,26,443,16007,439,11153,469
Kings,3/26/2021,1280,37814,374,821,85,527,15871,748,11901,612
Kings,3/27/2021,616,38430,245,359,12,170,15609,444,12345,182
Kings,3/28/2021,547,38977,476,64,7,342,15761,205,12550,357
Kings,3/29/2021,456,39433,201,195,60,251,15868,203,12753,310
Kings,3/30/2021,824,40257,452,334,38,415,15913,408,13161,453
Kings,3/31/2021,718,40975,371,283,64,416,16098,295,13456,480
Kings,4/1/2021,747,41722,375,293,79,342,16120,399,13855,421
Kings,4/2/2021,969,42691,419,428,122,425,16126,540,14395,546
Kings,4/3/2021,471,43162,327,136,8,159,15989,306,14701,169
Kings,4/4/2021,156,43318,82,68,6,44,15928,111,14812,50
Kings,4/5/2021,1036,44354,320,466,250,253,15649,782,15594,503
Kings,4/6/2021,1173,45527,446,420,307,292,15369,878,16472,598
Kings,4/7/2021,1335,46862,637,514,184,411,15042,922,17394,595
Kings,4/8/2021,1592,48454,627,713,252,363,14435,1222,18616,615
Kings,4/9/2021,1099,49553,523,402,174,235,13980,862,19478,407
Kings,4/10/2021,589,50142,328,159,102,177,13848,411,19889,279
Kings,4/11/2021,322,50464,74,242,6,190,13912,132,20021,196
Kings,4/12/2021,683,51147,307,178,198,189,13807,492,20513,387
Kings,4/13/2021,872,52019,502,370,0,283,13507,588,21101,288
Kings,4/14/2021,1016,53035,562,454,0,368,13228,648,21749,369
Kings,4/15/2021,1014,54049,495,518,1,452,13120,561,22310,453
Kings,4/16/2021,752,54801,351,401,0,264,12897,487,22797,264
Kings,4/17/2021,452,55253,241,211,0,198,12842,253,23050,198
Kings,4/18/2021,547,55800,237,310,0,69,12433,478,23528,69
Kings,4/19/2021,523,56323,288,233,2,285,12482,236,23764,285
Kings,4/20/2021,723,57046,438,285,0,241,12243,480,24244,241
Kings,4/21/2021,628,57674,303,325,0,221,12062,402,24646,221
Kings,4/22/2021,539,58213,277,262,0,197,11922,338,24984,198
Kings,4/23/2021,346,58559,53,293,0,190,11960,152,25136,190
Lake,12/17/2020,4,4,4,0,0,4,4,0,0,4
Lake,12/18/2020,51,55,51,0,0,51,55,0,0,51
Lake,12/19/2020,3,58,3,0,0,3,58,0,0,3
Lake,12/20/2020,6,64,6,0,0,6,64,0,0,6
Lake,12/21/2020,86,150,86,0,0,86,150,0,0,86
Lake,12/22/2020,63,213,60,3,0,63,213,0,0,63
Lake,12/23/2020,123,336,114,9,0,123,336,0,0,123
Lake,12/24/2020,2,338,0,2,0,2,338,0,0,2
Lake,12/26/2020,2,340,2,0,0,2,340,0,0,2
Lake,12/27/2020,2,342,2,0,0,2,342,0,0,2
Lake,12/28/2020,52,394,43,9,0,52,394,0,0,52
Lake,12/29/2020,49,443,44,5,0,49,443,0,0,49
Lake,12/30/2020,124,567,117,7,0,124,567,0,0,124
Lake,12/31/2020,67,634,64,3,0,67,634,0,0,67
Lake,1/1/2021,1,635,0,1,0,1,635,0,0,1
Lake,1/2/2021,2,637,1,1,0,2,637,0,0,2
Lake,1/4/2021,87,724,21,66,0,87,724,0,0,87
Lake,1/5/2021,119,843,59,60,0,117,839,2,2,117
Lake,1/6/2021,105,948,65,40,0,103,940,2,4,103
Lake,1/7/2021,104,1052,83,21,0,95,1026,9,13,95
Lake,1/8/2021,152,1204,124,28,0,100,1074,52,65,100
Lake,1/9/2021,63,1267,61,2,0,59,1129,4,69,59
Lake,1/10/2021,3,1270,3,0,0,0,1126,3,72,0
Lake,1/11/2021,192,1462,151,41,0,112,1158,80,152,112
Lake,1/12/2021,80,1542,48,32,0,56,1190,24,176,56
Lake,1/13/2021,164,1706,112,52,0,107,1240,57,233,107
Lake,1/14/2021,147,1853,46,101,0,125,1343,22,255,125
Lake,1/15/2021,215,2068,92,123,0,188,1504,27,282,188
Lake,1/16/2021,134,2202,81,53,0,132,1634,2,284,132
Lake,1/17/2021,18,2220,6,12,0,12,1640,6,290,12
Lake,1/18/2021,244,2464,224,20,0,126,1648,118,408,126
Lake,1/19/2021,311,2775,117,194,0,266,1870,45,453,267
Lake,1/20/2021,421,3196,80,341,0,357,2164,63,516,357
Lake,1/21/2021,433,3629,49,384,0,398,2527,35,551,398
Lake,1/22/2021,318,3947,46,272,0,282,2773,36,587,282
Lake,1/23/2021,122,4069,5,117,0,121,2893,1,588,121
Lake,1/24/2021,4,4073,1,3,0,4,2897,0,588,4
Lake,1/25/2021,257,4330,95,162,0,176,2992,81,669,176
Lake,1/26/2021,428,4758,36,392,0,405,3374,23,692,405
Lake,1/27/2021,356,5114,39,317,0,329,3677,27,719,330
Lake,1/28/2021,500,5614,160,340,0,372,3921,128,847,372
Lake,1/29/2021,637,6251,83,554,0,577,4438,60,907,577
Lake,1/30/2021,556,6807,45,511,0,550,4982,6,913,550
Lake,1/31/2021,14,6821,8,6,0,12,4992,2,915,12
Lake,2/1/2021,179,7000,18,161,0,166,5145,13,928,166
Lake,2/2/2021,563,7563,153,410,0,398,5378,165,1093,398
Lake,2/3/2021,445,8008,33,412,0,340,5613,105,1198,340
Lake,2/4/2021,118,8126,68,50,0,72,5639,46,1244,72
Lake,2/5/2021,377,8503,69,308,0,288,5840,87,1331,288
Lake,2/6/2021,275,8778,40,235,0,264,6093,11,1342,264
Lake,2/7/2021,2,8780,1,1,0,2,6095,0,1342,2
Lake,2/8/2021,279,9059,206,73,0,160,6136,119,1461,160
Lake,2/9/2021,347,9406,25,322,0,303,6396,43,1504,303
Lake,2/10/2021,350,9756,54,296,0,274,6594,76,1580,274
Lake,2/11/2021,169,9925,18,151,0,56,6537,113,1693,56
Lake,2/12/2021,375,10300,28,347,0,289,6740,86,1779,289
Lake,2/13/2021,249,10549,9,240,0,238,6967,11,1790,238
Lake,2/14/2021,19,10568,4,15,0,6,6960,13,1803,6
Lake,2/15/2021,172,10740,13,159,0,8,6805,163,1966,8
Lake,2/16/2021,420,11160,22,398,0,174,6733,246,2212,174
Lake,2/17/2021,351,11511,54,297,0,70,6523,280,2492,70
Lake,2/18/2021,456,11967,69,387,0,114,6295,342,2834,114
Lake,2/19/2021,414,12381,25,389,0,89,6059,325,3159,89
Lake,2/20/2021,294,12675,60,234,0,251,6268,42,3201,251
Lake,2/21/2021,6,12681,6,0,0,0,6262,6,3207,0
Lake,2/22/2021,139,12820,23,116,0,43,6209,96,3303,43
Lake,2/23/2021,212,13032,15,197,0,26,6049,186,3489,26
Lake,2/24/2021,957,13989,379,578,0,419,5931,537,4026,419
Lake,2/25/2021,732,14721,463,269,0,471,6143,259,4285,471
Lake,2/26/2021,994,15715,304,690,0,348,5848,643,4928,348
Lake,2/27/2021,410,16125,97,313,0,328,6094,82,5010,328
Lake,2/28/2021,18,16143,12,6,0,10,6096,8,5018,10
Lake,3/1/2021,594,16737,52,542,0,442,6386,152,5170,442
Lake,3/2/2021,744,17481,18,726,0,291,6223,454,5624,291
Lake,3/3/2021,359,17840,196,163,0,135,6134,224,5848,135
Lake,3/4/2021,576,18416,508,68,0,562,6682,14,5862,562
Lake,3/5/2021,1037,19453,40,997,0,174,5997,859,6721,174
Lake,3/6/2021,36,19489,11,24,1,21,6004,15,6736,22
Lake,3/7/2021,7,19496,5,2,0,4,6005,3,6739,4
Lake,3/8/2021,338,19834,267,62,9,298,6272,40,6779,307
Lake,3/9/2021,917,20751,29,871,17,392,6157,524,7303,409
Lake,3/10/2021,202,20953,60,129,13,135,6238,67,7370,148
Lake,3/11/2021,584,21537,47,62,475,49,6227,535,7905,524
Lake,3/12/2021,858,22395,205,629,24,365,6124,492,8397,389
Lake,3/13/2021,278,22673,21,20,237,16,6115,261,8658,252
Lake,3/14/2021,11,22684,2,9,0,7,6118,4,8662,7
Lake,3/15/2021,642,23326,14,611,17,483,6459,159,8821,500
Lake,3/16/2021,1115,24441,836,262,17,450,6264,661,9482,466
Lake,3/17/2021,246,24687,121,103,22,89,6218,157,9639,111
Lake,3/18/2021,751,25438,373,341,37,374,6252,376,10015,410
Lake,3/19/2021,581,26019,315,246,20,479,6650,101,10116,499
Lake,3/20/2021,249,26268,8,238,3,30,6466,217,10333,33
Lake,3/21/2021,17,26285,11,5,1,12,6474,5,10338,13
Lake,3/22/2021,320,26605,240,66,14,235,6638,85,10423,249
Lake,3/23/2021,416,27021,18,385,13,355,6946,60,10483,368
Lake,3/24/2021,413,27434,61,344,8,317,7177,95,10578,326
Lake,3/25/2021,658,28092,468,184,6,174,6873,484,11062,180
Lake,3/26/2021,70,28162,32,37,1,48,6900,22,11084,49
Lake,3/27/2021,309,28471,7,299,3,17,6630,290,11374,20
Lake,3/28/2021,16,28487,7,9,0,10,6634,6,11380,10
Lake,3/29/2021,899,29386,269,628,2,193,6125,704,12084,195
Lake,3/30/2021,452,29838,304,146,2,366,6408,85,12169,368
Lake,3/31/2021,582,30420,62,519,1,416,6667,158,12327,417
Lake,4/1/2021,429,30849,224,193,12,181,6615,245,12572,193
Lake,4/2/2021,224,31073,43,153,28,101,6621,123,12695,129
Lake,4/3/2021,30,31103,7,20,3,11,6616,19,12714,14
Lake,4/4/2021,20,31123,10,8,2,15,6628,5,12719,17
Lake,4/5/2021,634,31757,69,546,19,396,6807,235,12954,414
Lake,4/6/2021,471,32228,15,430,26,299,6961,171,13125,325
Lake,4/7/2021,515,32743,55,410,50,350,7198,163,13288,400
Lake,4/8/2021,597,33340,485,45,67,102,6875,492,13780,169
Lake,4/9/2021,283,33623,44,170,69,49,6762,231,14011,118
Lake,4/10/2021,253,33876,15,14,224,11,6755,242,14253,235
Lake,4/11/2021,22,33898,17,3,2,7,6749,15,14268,9
Lake,4/12/2021,1066,34964,231,803,32,248,6212,817,15085,280
Lake,4/13/2021,180,35144,109,71,0,53,6138,127,15212,53
Lake,4/14/2021,606,35750,36,570,0,546,6624,60,15272,546
Lake,4/15/2021,622,36372,176,446,0,315,6632,307,15579,315
Lake,4/16/2021,255,36627,22,232,1,67,6513,187,15766,68
Lake,4/17/2021,38,36665,10,28,0,28,6531,10,15776,28
Lake,4/18/2021,8,36673,5,3,0,0,6523,8,15784,0
Lake,4/19/2021,297,36970,40,257,0,246,6718,51,15835,246
Lake,4/20/2021,687,37657,274,413,0,112,6257,574,16409,113
Lake,4/21/2021,521,38178,58,463,0,194,6125,326,16735,194
Lake,4/22/2021,416,38594,39,377,0,275,6259,141,16876,275
Lake,4/23/2021,48,38642,30,18,0,34,6279,14,16890,34
Lassen,12/16/2020,8,8,8,0,0,8,8,0,0,8
Lassen,12/17/2020,6,14,6,0,0,6,14,0,0,6
Lassen,12/18/2020,1,15,1,0,0,1,15,0,0,1
Lassen,12/19/2020,5,20,5,0,0,5,20,0,0,5
Lassen,12/20/2020,2,22,2,0,0,2,22,0,0,2
Lassen,12/21/2020,11,33,11,0,0,11,33,0,0,11
Lassen,12/22/2020,23,56,23,0,0,23,56,0,0,23
Lassen,12/23/2020,6,62,6,0,0,6,62,0,0,6
Lassen,12/24/2020,11,73,11,0,0,11,73,0,0,11
Lassen,12/28/2020,3,76,2,1,0,3,76,0,0,3
Lassen,12/29/2020,35,111,35,0,0,35,111,0,0,35
Lassen,12/30/2020,37,148,36,1,0,37,148,0,0,37
Lassen,12/31/2020,49,197,42,7,0,49,197,0,0,49
Lassen,1/2/2021,1,198,0,1,0,1,198,0,0,1
Lassen,1/4/2021,15,213,1,14,0,15,213,0,0,15
Lassen,1/5/2021,194,407,53,141,0,194,407,0,0,194
Lassen,1/6/2021,93,500,42,51,0,85,485,8,8,86
Lassen,1/7/2021,43,543,7,36,0,37,516,6,14,37
Lassen,1/8/2021,50,593,2,48,0,50,566,0,14,50
Lassen,1/9/2021,12,605,6,6,0,12,578,0,14,12
Lassen,1/11/2021,27,632,5,22,0,27,605,0,14,27
Lassen,1/12/2021,49,681,29,20,0,30,616,19,33,30
Lassen,1/13/2021,161,842,18,143,0,146,747,15,48,146
Lassen,1/14/2021,163,1005,18,145,0,151,886,12,60,151
Lassen,1/15/2021,33,1038,6,27,0,33,919,0,60,33
Lassen,1/16/2021,34,1072,33,1,0,34,953,0,60,34
Lassen,1/17/2021,1,1073,0,1,0,1,954,0,60,1
Lassen,1/18/2021,5,1078,2,3,0,4,957,1,61,4
Lassen,1/19/2021,185,1263,36,149,0,157,1086,28,89,157
Lassen,1/20/2021,188,1451,100,88,0,104,1121,69,158,104
Lassen,1/21/2021,144,1595,93,51,0,120,1223,18,176,120
Lassen,1/22/2021,31,1626,18,13,0,21,1234,10,186,21
Lassen,1/23/2021,2,1628,0,2,0,2,1236,0,186,2
Lassen,1/24/2021,1,1629,0,1,0,1,1237,0,186,1
Lassen,1/25/2021,11,1640,0,11,0,11,1248,0,186,11
Lassen,1/26/2021,126,1766,12,114,0,122,1366,4,190,122
Lassen,1/27/2021,85,1851,33,52,0,69,1419,16,206,69
Lassen,1/28/2021,85,1936,14,71,0,84,1502,1,207,84
Lassen,1/29/2021,23,1959,7,16,0,22,1523,1,208,22
Lassen,2/1/2021,62,2021,4,58,0,36,1533,26,234,36
Lassen,2/2/2021,177,2198,12,165,0,44,1444,133,367,44
Lassen,2/3/2021,96,2294,21,75,0,51,1450,45,412,51
Lassen,2/4/2021,112,2406,15,97,0,63,1464,49,461,63
Lassen,2/5/2021,65,2471,12,53,0,23,1445,42,503,23
Lassen,2/6/2021,70,2541,35,35,0,37,1450,32,535,37
Lassen,2/7/2021,2,2543,2,0,0,2,1452,0,535,2
Lassen,2/8/2021,43,2586,4,39,0,18,1445,25,560,18
Lassen,2/9/2021,129,2715,8,121,0,50,1416,79,639,50
Lassen,2/10/2021,182,2897,20,162,0,75,1384,107,746,75
Lassen,2/11/2021,184,3081,16,168,0,80,1361,103,849,80
Lassen,2/12/2021,42,3123,11,31,0,14,1347,28,877,14
Lassen,2/13/2021,11,3134,3,8,0,9,1354,2,879,9
Lassen,2/14/2021,13,3147,0,13,0,12,1365,1,880,12
Lassen,2/15/2021,21,3168,2,19,0,17,1378,4,884,17
Lassen,2/16/2021,192,3360,4,188,0,31,1250,159,1043,31
Lassen,2/17/2021,184,3544,94,90,0,11,1088,173,1216,11
Lassen,2/18/2021,79,3623,22,57,0,20,1049,59,1275,20
Lassen,2/19/2021,82,3705,62,20,0,18,1003,64,1339,18
Lassen,2/20/2021,7,3712,0,7,0,5,1006,2,1341,5
Lassen,2/21/2021,22,3734,2,20,0,18,1020,4,1345,18
Lassen,2/22/2021,23,3757,8,15,0,5,1007,18,1363,5
Lassen,2/23/2021,153,3910,10,143,0,41,936,112,1475,41
Lassen,2/24/2021,166,4076,17,149,0,108,987,57,1532,108
Lassen,2/25/2021,156,4232,19,137,0,99,1029,57,1589,99
Lassen,2/26/2021,73,4305,16,57,0,36,1028,37,1626,36
Lassen,2/27/2021,8,4313,7,1,0,3,1026,5,1631,3
Lassen,2/28/2021,6,4319,1,5,0,3,1026,3,1634,3
Lassen,3/1/2021,41,4360,4,37,0,8,1001,33,1667,8
Lassen,3/2/2021,107,4467,9,98,0,80,1054,27,1694,80
Lassen,3/3/2021,170,4637,12,158,0,113,1110,57,1751,113
Lassen,3/4/2021,147,4784,14,133,0,98,1160,48,1799,98
Lassen,3/5/2021,47,4831,7,17,23,11,1158,36,1835,34
Lassen,3/6/2021,55,4886,5,28,22,5,1135,50,1885,27
Lassen,3/7/2021,56,4942,1,0,55,1,1136,55,1940,56
Lassen,3/8/2021,90,5032,2,8,80,3,1133,86,2026,83
Lassen,3/9/2021,137,5169,11,109,17,88,1190,49,2075,106
Lassen,3/10/2021,173,5342,10,162,1,79,1177,93,2168,80
Lassen,3/11/2021,185,5527,16,162,7,113,1228,69,2237,120
Lassen,3/12/2021,35,5562,18,13,4,12,1221,23,2260,16
Lassen,3/13/2021,49,5611,0,3,46,1,1219,48,2308,46
Lassen,3/14/2021,14,5625,2,11,1,2,1210,12,2320,3
Lassen,3/15/2021,32,5657,1,31,0,16,1210,16,2336,16
Lassen,3/16/2021,93,5750,2,85,6,75,1273,18,2354,81
Lassen,3/17/2021,1086,6836,9,1072,5,1066,2324,20,2374,1071
Lassen,3/18/2021,95,6931,9,85,1,81,2392,14,2388,82
Lassen,3/19/2021,17,6948,11,2,4,7,2393,10,2398,11
Lassen,3/20/2021,28,6976,3,22,3,22,2412,6,2404,25
Lassen,3/21/2021,34,7010,0,34,0,14,2407,19,2423,14
Lassen,3/22/2021,57,7067,1,56,0,54,2458,3,2426,54
Lassen,3/23/2021,117,7184,9,107,1,66,2474,51,2477,67
Lassen,3/24/2021,212,7396,13,199,0,107,2477,104,2581,107
Lassen,3/25/2021,151,7547,20,131,0,69,2464,82,2663,69
Lassen,3/26/2021,77,7624,12,26,39,18,2462,59,2722,57
Lassen,3/27/2021,20,7644,4,1,15,3,2463,17,2739,18
Lassen,3/28/2021,18,7662,3,5,10,4,2463,14,2753,14
Lassen,3/29/2021,52,7714,0,27,25,20,2477,31,2784,45
Lassen,3/30/2021,198,7912,10,163,25,51,2406,147,2931,76
Lassen,3/31/2021,146,8058,12,112,22,62,2406,84,3015,84
Lassen,4/1/2021,166,8224,16,131,19,49,2358,116,3131,68
Lassen,4/2/2021,29,8253,4,3,22,2,2355,27,3158,24
Lassen,4/3/2021,12,8265,0,2,10,0,2353,12,3170,10
Lassen,4/4/2021,7,8272,2,0,5,1,2353,6,3176,6
Lassen,4/5/2021,23,8295,4,12,7,11,2360,11,3187,18
Lassen,4/6/2021,183,8478,8,145,30,52,2311,131,3318,82
Lassen,4/7/2021,135,8613,5,93,37,32,2279,103,3421,71
Lassen,4/8/2021,169,8782,8,105,56,33,2236,132,3553,89
Lassen,4/9/2021,52,8834,6,11,35,9,2237,42,3595,43
Lassen,4/10/2021,9,8843,0,2,7,0,2236,8,3603,7
Lassen,4/11/2021,5,8848,2,0,3,2,2238,3,3606,5
Lassen,4/12/2021,25,8873,2,10,13,1,2228,24,3630,14
Lassen,4/13/2021,129,9002,6,123,0,40,2180,88,3718,40
Lassen,4/14/2021,986,9988,16,970,0,50,1295,935,4653,50
Lassen,4/15/2021,147,10135,14,133,0,19,1186,128,4781,19
Lassen,4/16/2021,10,10145,3,7,0,5,1186,5,4786,5
Lassen,4/17/2021,24,10169,3,21,0,4,1170,20,4806,4
Lassen,4/18/2021,5,10174,2,3,0,2,1169,3,4809,2
Lassen,4/19/2021,32,10206,0,32,0,16,1169,16,4825,16
Lassen,4/20/2021,133,10339,7,126,0,48,1132,85,4910,48
Lassen,4/21/2021,137,10476,7,128,2,32,1060,104,5014,32
Lassen,4/22/2021,39,10515,13,26,0,28,1077,11,5025,28
Lassen,4/23/2021,16,10531,1,14,1,9,1079,7,5032,9
Los Angeles,12/15/2020,391,391,391,0,0,391,391,0,0,391
Los Angeles,12/16/2020,3364,3755,3364,0,0,3364,3755,0,0,3364
Los Angeles,12/17/2020,10229,13984,10229,0,0,10230,13985,0,0,10230
Los Angeles,12/18/2020,14502,28486,14478,24,0,14502,28487,0,0,14502
Los Angeles,12/19/2020,7220,35706,7212,8,0,7221,35708,0,0,7221
Los Angeles,12/20/2020,4582,40288,4575,7,0,4584,40292,0,0,4584
Los Angeles,12/21/2020,13679,53967,13665,14,0,13680,53971,1,1,13680
Los Angeles,12/22/2020,11515,65482,11134,381,0,11516,65486,1,2,11516
Los Angeles,12/23/2020,11873,77355,10121,1752,0,11874,77360,0,2,11874
Los Angeles,12/24/2020,7011,84366,4245,2766,0,7014,84374,0,2,7014
Los Angeles,12/25/2020,524,84890,419,105,0,524,84898,0,2,524
Los Angeles,12/26/2020,2523,87413,2178,345,0,2523,87420,1,3,2523
Los Angeles,12/27/2020,1757,89170,1027,730,0,1757,89177,0,3,1757
Los Angeles,12/28/2020,10264,99434,6366,3898,0,10262,99438,1,4,10262
Los Angeles,12/29/2020,11581,111015,6064,5517,0,11583,111021,0,4,11583
Los Angeles,12/30/2020,14847,125862,8079,6768,0,14846,125867,0,4,14846
Los Angeles,12/31/2020,7911,133773,2749,5162,0,7909,133775,1,5,7909
Los Angeles,1/1/2021,976,134749,263,713,0,976,134751,0,5,976
Los Angeles,1/2/2021,4444,139193,1650,2794,0,4444,139195,0,5,4444
Los Angeles,1/3/2021,927,140120,209,718,0,926,140120,1,6,926
Los Angeles,1/4/2021,12662,152782,4851,7811,0,12648,152765,3,9,12648
Los Angeles,1/5/2021,15970,168752,7053,8917,0,14071,164966,1872,1881,14073
Los Angeles,1/6/2021,22488,191240,12046,10442,0,16904,176361,5516,7397,16911
Los Angeles,1/7/2021,29331,220571,15792,13539,0,18842,184770,10444,17841,18853
Los Angeles,1/8/2021,33042,253613,17880,15162,0,20840,193442,12176,30017,20848
Los Angeles,1/9/2021,12339,265952,7062,5277,0,7479,196068,4859,34876,7485
Los Angeles,1/10/2021,4646,270598,3626,1020,0,1919,195261,2727,37603,1920
Los Angeles,1/11/2021,25761,296359,16226,9535,0,14834,199187,10916,48519,14842
Los Angeles,1/12/2021,29188,325547,16064,13124,0,19063,208151,10107,58626,19071
Los Angeles,1/13/2021,29222,354769,15606,13616,0,20287,219525,8918,67544,20292
Los Angeles,1/14/2021,29211,383980,12702,16509,0,23714,237770,5478,73022,23723
Los Angeles,1/15/2021,33746,417726,12335,21411,0,30179,264414,3542,76564,30186
Los Angeles,1/16/2021,17545,435271,4963,12582,0,15767,278415,1770,78334,15771
Los Angeles,1/17/2021,5181,440452,2301,2880,0,4936,283109,244,78578,4938
Los Angeles,1/18/2021,15562,456014,10049,5513,0,10859,289279,4691,83269,10861
Los Angeles,1/19/2021,38405,494419,20537,17868,0,30632,312186,7732,91001,30639
Los Angeles,1/20/2021,45537,539956,23721,21816,0,38055,342797,7452,98453,38063
Los Angeles,1/21/2021,48561,588517,22385,26176,0,44306,382923,4194,102647,44320
Los Angeles,1/22/2021,47740,636257,22198,25542,0,44338,423911,3359,106006,44347
Los Angeles,1/23/2021,33925,670182,15693,18232,0,31883,453795,2010,108016,31894
Los Angeles,1/24/2021,15718,685900,12203,3515,0,15169,468423,542,108558,15170
Los Angeles,1/25/2021,38624,724524,16391,22233,0,30173,490191,8422,116980,30190
Los Angeles,1/26/2021,49148,773672,24387,24761,0,40994,523082,8121,125101,41012
Los Angeles,1/27/2021,48367,822039,25769,22598,0,39205,553280,9027,134128,39225
Los Angeles,1/28/2021,48453,870492,23052,25401,0,40090,585145,8244,142372,40109
Los Angeles,1/29/2021,49158,919650,25351,23807,0,39137,614634,9670,152042,39159
Los Angeles,1/30/2021,29946,949596,15382,14564,0,25822,636410,4049,156091,25825
Los Angeles,1/31/2021,12987,962583,10355,2632,0,12069,647576,906,156997,12072
Los Angeles,2/1/2021,37912,1000495,16130,21782,0,27678,665059,10204,167201,27687
Los Angeles,2/2/2021,44128,1044623,17856,26272,0,31986,684943,12105,179306,31989
Los Angeles,2/3/2021,51963,1096586,19444,32519,0,37313,707845,14417,193723,37319
Los Angeles,2/4/2021,57097,1153683,20673,36424,0,39077,729219,17714,211437,39088
Los Angeles,2/5/2021,61038,1214721,21004,40034,0,39221,747047,21399,232836,39227
Los Angeles,2/6/2021,35432,1250153,13270,22162,0,27032,765773,8327,241163,27053
Los Angeles,2/7/2021,10778,1260931,8366,2412,0,8398,771811,2365,243528,8403
Los Angeles,2/8/2021,46660,1307591,21454,25206,0,30538,786360,15991,259519,30540
Los Angeles,2/9/2021,55667,1363258,24559,31108,0,28361,787486,27241,286760,28367
Los Angeles,2/10/2021,66773,1430031,29348,37425,0,30942,782974,35461,322221,30949
Los Angeles,2/11/2021,57887,1487918,30822,27065,0,28002,781530,29448,351669,28004
Los Angeles,2/12/2021,59428,1547346,29760,29668,0,25950,774348,33148,384817,25966
Los Angeles,2/13/2021,33765,1581111,19600,14165,0,15456,771614,18226,403043,15492
Los Angeles,2/14/2021,21856,1602967,14952,6904,0,8771,767363,13025,416068,8774
Los Angeles,2/15/2021,32360,1635327,15822,16538,0,17762,770591,14540,430608,17768
Los Angeles,2/16/2021,63867,1699194,32449,31418,0,29836,766487,33952,464560,29848
Los Angeles,2/17/2021,63882,1763076,34204,29678,0,26338,755451,37380,501940,26344
Los Angeles,2/18/2021,67926,1831002,34643,33283,0,28580,744868,39172,541112,28589
Los Angeles,2/19/2021,56903,1887905,34961,21942,0,28283,744638,28527,569639,28297
Los Angeles,2/20/2021,32055,1919960,23799,8256,0,15664,743958,16352,585991,15672
Los Angeles,2/21/2021,16573,1936533,14935,1638,0,8464,744347,8078,594069,8467
Los Angeles,2/22/2021,34208,1970741,24913,9295,0,17705,745631,16431,610500,17715
Los Angeles,2/23/2021,53422,2024163,22656,30766,0,21060,734440,32262,642762,21071
Los Angeles,2/24/2021,63789,2087952,28012,35777,0,27983,726791,35649,678411,28000
Los Angeles,2/25/2021,73275,2161227,33653,39622,0,38530,730736,34596,713007,38541
Los Angeles,2/26/2021,82570,2243797,38498,44072,0,47307,743030,35040,748047,47334
Los Angeles,2/27/2021,58442,2302239,24829,33609,4,29867,744489,28435,776482,29894
Los Angeles,2/28/2021,26724,2328963,18450,8273,1,18828,755507,7818,784300,18836
Los Angeles,3/1/2021,55304,2384267,30973,24317,14,33536,767447,21625,805925,33565
Los Angeles,3/2/2021,70690,2454957,31303,39385,2,43191,783261,27388,833313,43202
Los Angeles,3/3/2021,81926,2536883,41004,40915,7,51421,804356,30355,863668,51450
Los Angeles,3/4/2021,88777,2625660,45595,43172,10,55885,827545,32722,896390,55911
Los Angeles,3/5/2021,87327,2712987,42540,44763,24,58234,856908,28927,925317,58290
Los Angeles,3/6/2021,65687,2778674,32859,31020,1808,42189,877544,23367,948684,44003
Los Angeles,3/7/2021,25596,2804270,19258,5547,791,19732,892224,5841,954525,20521
Los Angeles,3/8/2021,51183,2855453,26581,22665,1937,38489,920046,12602,967127,40424
Los Angeles,3/9/2021,68424,2923877,26036,39121,3267,40814,936652,27470,994597,44076
Los Angeles,3/10/2021,78539,3002416,37056,36840,4643,49313,961494,29082,1023679,53924
Los Angeles,3/11/2021,91214,3093630,44333,40501,6380,53540,983868,37515,1061194,59889
Los Angeles,3/12/2021,96409,3190039,42718,39983,13708,56072,1013443,40165,1101359,69740
Los Angeles,3/13/2021,73446,3263485,33943,27627,11876,43643,1039219,29705,1131064,55481
Los Angeles,3/14/2021,37944,3301429,25341,10193,2410,25453,1054629,12435,1143499,27845
Los Angeles,3/15/2021,73294,3374723,35430,32552,5312,44736,1076279,28388,1171887,50038
Los Angeles,3/16/2021,97701,3472424,41986,49975,5740,63749,1111963,33779,1205666,69463
Los Angeles,3/17/2021,94830,3567254,42567,44080,8183,63682,1152747,30978,1236644,71762
Los Angeles,3/18/2021,98199,3665453,46853,46174,5172,62530,1185013,35424,1272068,67690
Los Angeles,3/19/2021,104967,3770420,54598,45710,4659,65204,1215303,39536,1311604,69826
Los Angeles,3/20/2021,74139,3844559,36053,33834,4252,51560,1248676,22428,1334032,55801
Los Angeles,3/21/2021,33487,3878046,24718,7926,843,21769,1259657,11627,1345659,22608
Los Angeles,3/22/2021,67697,3945743,40092,25643,1962,48279,1290681,19216,1364875,50240
Los Angeles,3/23/2021,93031,4038774,50141,39977,2913,62008,1324782,30811,1395686,64912
Los Angeles,3/24/2021,101836,4140610,54141,44832,2863,60449,1346976,41108,1436794,63302
Los Angeles,3/25/2021,106656,4247266,57050,45985,3621,61334,1366840,45078,1481872,64942
Los Angeles,3/26/2021,111386,4358652,60790,46514,4082,63483,1386730,47663,1529535,67553
Los Angeles,3/27/2021,80655,4439307,42248,36294,2113,42145,1392699,38291,1567826,44260
Los Angeles,3/28/2021,40747,4480054,27258,12907,582,20739,1394098,19922,1587748,21321
Los Angeles,3/29/2021,80988,4561042,45728,33676,1584,46500,1407855,34325,1622073,48082
Los Angeles,3/30/2021,105887,4666929,49575,50620,5692,65315,1438455,40389,1662462,70989
Los Angeles,3/31/2021,119175,4786104,59794,50896,8485,70115,1468194,48833,1711295,78572
Los Angeles,4/1/2021,129291,4915395,60225,54341,14725,70915,1495651,58147,1769442,85604
Los Angeles,4/2/2021,127384,5042779,56258,56357,14769,68708,1520728,58396,1827838,83473
Los Angeles,4/3/2021,94741,5137520,42653,39092,12996,47421,1533936,47182,1875020,60390
Los Angeles,4/4/2021,38815,5176335,20276,11979,6560,16678,1535077,22081,1897101,23222
Los Angeles,4/5/2021,90288,5266623,43791,36619,9878,44455,1543717,45679,1942780,54319
Los Angeles,4/6/2021,119209,5385832,56017,43174,20018,55437,1555538,63567,2006347,75388
Los Angeles,4/7/2021,118182,5504014,53845,43518,20819,54097,1566523,63868,2070215,74853
Los Angeles,4/8/2021,130088,5634102,57115,49216,23757,59383,1579119,70474,2140689,83070
Los Angeles,4/9/2021,128268,5762370,55576,49326,23366,55688,1585753,72344,2213033,78978
Los Angeles,4/10/2021,98420,5860790,41392,33405,23623,36465,1584023,61760,2274793,60030
Los Angeles,4/11/2021,40887,5901677,22203,9567,9117,14222,1580729,26605,2301398,23311
Los Angeles,4/12/2021,77454,5979131,38155,33160,6139,32320,1574192,44961,2346359,38424
Los Angeles,4/13/2021,115369,6094500,58143,56835,391,61378,1582170,53793,2400152,61771
Los Angeles,4/14/2021,115089,6209589,58378,56599,112,62759,1592931,52105,2452257,62866
Los Angeles,4/15/2021,124853,6334442,67759,56939,155,71350,1611160,53276,2505533,71505
Los Angeles,4/16/2021,125953,6460395,67358,58457,138,66862,1619293,58871,2564404,67004
Los Angeles,4/17/2021,94965,6555360,50309,44647,9,54038,1632586,40761,2605165,54054
Los Angeles,4/18/2021,33625,6588985,22270,11354,1,18625,1636268,14950,2620115,18632
Los Angeles,4/19/2021,72721,6661706,38856,33840,25,32590,1628906,39983,2660098,32621
Los Angeles,4/20/2021,97382,6759088,47413,49961,8,48609,1628944,48580,2708678,48618
Los Angeles,4/21/2021,105503,6864591,51202,54114,187,46997,1617869,58263,2766941,47188
Los Angeles,4/22/2021,91019,6955610,52301,38692,26,40549,1608185,50264,2817205,40580
Los Angeles,4/23/2021,47543,7003153,28540,18996,7,25523,1611840,21874,2839079,25529
Madera,12/16/2020,22,22,22,0,0,22,22,0,0,22
Madera,12/17/2020,13,35,13,0,0,13,35,0,0,13
Madera,12/18/2020,61,96,61,0,0,61,96,0,0,61
Madera,12/19/2020,5,101,5,0,0,5,101,0,0,5
Madera,12/20/2020,14,115,14,0,0,14,115,0,0,14
Madera,12/21/2020,60,175,60,0,0,60,175,0,0,60
Madera,12/22/2020,97,272,95,2,0,97,272,0,0,97
Madera,12/23/2020,68,340,68,0,0,68,340,0,0,68
Madera,12/24/2020,44,384,39,5,0,44,384,0,0,44
Madera,12/26/2020,28,412,26,2,0,28,412,0,0,28
Madera,12/27/2020,30,442,12,18,0,30,442,0,0,30
Madera,12/28/2020,105,547,36,69,0,105,547,0,0,105
Madera,12/29/2020,174,721,40,134,0,174,721,0,0,174
Madera,12/30/2020,218,939,86,132,0,218,939,0,0,218
Madera,12/31/2020,201,1140,80,121,0,201,1140,0,0,201
Madera,1/1/2021,1,1141,1,0,0,1,1141,0,0,1
Madera,1/2/2021,89,1230,34,55,0,89,1230,0,0,89
Madera,1/3/2021,5,1235,5,0,0,5,1235,0,0,5
Madera,1/4/2021,129,1364,65,64,0,129,1364,0,0,129
Madera,1/5/2021,279,1643,143,136,0,275,1635,4,4,275
Madera,1/6/2021,184,1827,27,157,0,164,1779,20,24,164
Madera,1/7/2021,394,2221,113,281,0,372,2129,22,46,372
Madera,1/8/2021,419,2640,72,347,0,364,2440,54,100,365
Madera,1/9/2021,37,2677,14,23,0,28,2459,9,109,28
Madera,1/10/2021,17,2694,14,3,0,5,2452,12,121,5
Madera,1/11/2021,238,2932,190,48,0,195,2604,43,164,195
Madera,1/12/2021,390,3322,157,233,0,284,2782,106,270,284
Madera,1/13/2021,185,3507,91,94,0,129,2856,56,326,130
Madera,1/14/2021,554,4061,82,472,0,520,3342,34,360,520
Madera,1/15/2021,598,4659,159,439,0,578,3900,20,380,578
Madera,1/16/2021,382,5041,47,335,0,353,4224,29,409,353
Madera,1/17/2021,335,5376,15,320,0,331,4551,4,413,331
Madera,1/18/2021,76,5452,60,16,0,57,4590,18,431,57
Madera,1/19/2021,570,6022,135,435,0,543,5107,27,458,544
Madera,1/20/2021,234,6256,80,154,0,206,5286,27,485,206
Madera,1/21/2021,237,6493,130,107,0,204,5459,31,516,204
Madera,1/22/2021,257,6750,83,174,0,243,5688,14,530,243
Madera,1/23/2021,100,6850,52,48,0,76,5740,24,554,76
Madera,1/24/2021,101,6951,82,19,0,78,5795,23,577,78
Madera,1/25/2021,255,7206,124,131,0,142,5824,113,690,142
Madera,1/26/2021,481,7687,189,292,0,292,5930,188,878,294
Madera,1/27/2021,737,8424,63,674,0,601,6396,136,1014,602
Madera,1/28/2021,536,8960,103,433,0,433,6726,103,1117,433
Madera,1/29/2021,468,9428,95,373,0,412,7082,56,1173,412
Madera,1/30/2021,504,9932,16,488,0,450,7478,54,1227,450
Madera,1/31/2021,10,9942,7,3,0,9,7486,1,1228,9
Madera,2/1/2021,256,10198,72,184,0,197,7624,59,1287,197
Madera,2/2/2021,252,10450,87,165,0,161,7696,90,1377,162
Madera,2/3/2021,592,11042,459,133,0,473,8053,117,1494,474
Madera,2/4/2021,385,11427,120,265,0,111,7892,273,1767,112
Madera,2/5/2021,974,12401,297,677,0,368,7660,601,2368,369
Madera,2/6/2021,360,12761,325,35,0,321,7943,38,2406,321
Madera,2/7/2021,35,12796,7,28,0,30,7968,5,2411,30
Madera,2/8/2021,382,13178,306,76,0,269,8125,112,2523,269
Madera,2/9/2021,479,13657,119,360,0,197,8044,279,2802,198
Madera,2/10/2021,428,14085,148,280,0,322,8260,106,2908,322
Madera,2/11/2021,932,15017,304,628,0,404,8138,527,3435,405
Madera,2/12/2021,842,15859,119,723,0,310,7925,526,3961,313
Madera,2/13/2021,484,16343,44,440,0,139,7722,344,4305,141
Madera,2/14/2021,400,16743,75,325,0,137,7597,263,4568,138
Madera,2/15/2021,244,16987,98,146,0,175,7704,68,4636,175
Madera,2/16/2021,774,17761,183,591,0,230,7394,541,5177,231
Madera,2/17/2021,608,18369,273,335,0,339,7471,264,5441,341
Madera,2/18/2021,1297,19666,538,759,0,1121,8418,176,5617,1123
Madera,2/19/2021,860,20526,545,315,0,718,8996,142,5759,720
Madera,2/20/2021,1069,21595,978,91,0,998,9925,70,5829,999
Madera,2/21/2021,965,22560,821,144,0,959,10878,6,5835,959
Madera,2/22/2021,908,23468,832,76,0,854,11678,54,5889,854
Madera,2/23/2021,769,24237,497,272,0,549,12008,219,6108,549
Madera,2/24/2021,906,25143,300,606,0,377,11856,529,6637,377
Madera,2/25/2021,1019,26162,307,712,0,590,12019,427,7064,590
Madera,2/26/2021,1070,27232,185,885,0,695,12341,373,7437,695
Madera,2/27/2021,868,28100,244,624,0,446,12371,419,7856,449
Madera,2/28/2021,188,28288,29,159,0,182,12547,6,7862,182
Madera,3/1/2021,369,28657,116,253,0,191,12561,177,8039,191
Madera,3/2/2021,649,29306,267,382,0,537,12987,112,8151,538
Madera,3/3/2021,1305,30611,696,609,0,906,13521,396,8547,930
Madera,3/4/2021,1162,31773,502,660,0,920,14201,243,8790,923
Madera,3/5/2021,1324,33097,405,907,12,1062,15026,260,9050,1085
Madera,3/6/2021,803,33900,622,149,32,484,15224,319,9369,517
Madera,3/7/2021,153,34053,27,104,22,103,15299,50,9419,125
Madera,3/8/2021,595,34648,335,201,59,302,15369,293,9712,363
Madera,3/9/2021,449,35097,158,257,34,275,15514,172,9884,317
Madera,3/10/2021,1130,36227,507,546,77,704,15874,422,10306,782
Madera,3/11/2021,1655,37882,842,481,332,748,16060,905,11211,1091
Madera,3/12/2021,1527,39409,778,595,154,750,16214,775,11986,929
Madera,3/13/2021,1811,41220,1268,345,198,746,16111,1063,13049,960
Madera,3/14/2021,581,41801,448,101,32,293,16150,286,13335,325
Madera,3/15/2021,728,42529,213,469,46,505,16507,220,13555,577
Madera,3/16/2021,820,43349,420,353,47,638,17030,179,13734,702
Madera,3/17/2021,1417,44766,935,420,62,863,17499,546,14280,1015
Madera,3/18/2021,1870,46636,646,1164,60,910,17601,952,15232,1054
Madera,3/19/2021,1494,48130,588,822,84,960,18181,528,15760,1108
Madera,3/20/2021,1130,49260,772,307,51,579,18307,550,16310,676
Madera,3/21/2021,1071,50331,872,154,45,355,17995,713,17023,401
Madera,3/22/2021,1356,51687,851,437,68,684,18120,669,17692,794
Madera,3/23/2021,1395,53082,840,464,91,737,18374,656,18348,910
Madera,3/24/2021,901,53983,467,403,31,599,18708,300,18648,634
Madera,3/25/2021,1122,55105,488,610,24,642,18918,469,19117,679
Madera,3/26/2021,1435,56540,508,796,131,674,18971,755,19872,808
Madera,3/27/2021,824,57364,525,278,21,369,18912,449,20321,390
Madera,3/28/2021,420,57784,136,223,61,230,19066,189,20510,343
Madera,3/29/2021,681,58465,178,476,27,492,19403,186,20696,523
Madera,3/30/2021,1015,59480,561,422,32,557,19538,455,21151,590
Madera,3/31/2021,1297,60777,486,697,114,451,19263,841,21992,566
Madera,4/1/2021,1224,62001,535,640,49,437,18966,782,22774,485
Madera,4/2/2021,1506,63507,411,1037,58,460,18449,1037,23811,520
Madera,4/3/2021,871,64378,681,170,20,379,18367,490,24301,408
Madera,4/4/2021,184,64562,65,117,2,85,18355,99,24400,87
Madera,4/5/2021,733,65295,254,422,57,340,18374,392,24792,411
Madera,4/6/2021,1687,66982,877,462,348,636,18307,1050,25842,983
Madera,4/7/2021,1194,68176,371,674,149,452,18174,739,26581,606
Madera,4/8/2021,1673,69849,655,767,251,559,17881,1110,27691,817
Madera,4/9/2021,1605,71454,670,788,147,940,18311,660,28351,1090
Madera,4/10/2021,944,72398,675,202,67,698,18832,245,28596,766
Madera,4/11/2021,770,73168,628,65,77,285,18710,483,29079,361
Madera,4/12/2021,777,73945,265,434,78,301,18614,476,29555,380
Madera,4/13/2021,1233,75178,609,583,41,730,18894,501,30056,781
Madera,4/14/2021,1354,76532,836,518,0,570,18689,781,30837,576
Madera,4/15/2021,1080,77612,454,625,1,428,18478,641,31478,430
Madera,4/16/2021,1243,78855,515,728,0,427,18100,806,32284,428
Madera,4/17/2021,1263,80118,1064,199,0,827,18492,435,32719,827
Madera,4/18/2021,241,80359,205,36,0,98,18448,142,32861,98
Madera,4/19/2021,794,81153,232,561,1,268,18196,521,33382,269
Madera,4/20/2021,857,82010,417,440,0,236,17816,618,34000,238
Madera,4/21/2021,843,82853,448,395,0,293,17565,546,34546,295
Madera,4/22/2021,1028,83881,506,522,0,378,17298,645,35191,378
Madera,4/23/2021,506,84387,179,326,1,208,17212,295,35486,209
Marin,12/15/2020,2,2,2,0,0,2,2,0,0,2
Marin,12/16/2020,107,109,107,0,0,107,109,0,0,107
Marin,12/17/2020,260,369,260,0,0,260,369,0,0,260
Marin,12/18/2020,372,741,372,0,0,372,741,0,0,372
Marin,12/19/2020,350,1091,349,1,0,350,1091,0,0,350
Marin,12/20/2020,167,1258,166,1,0,167,1258,0,0,167
Marin,12/21/2020,238,1496,235,3,0,238,1496,0,0,238
Marin,12/22/2020,523,2019,319,204,0,523,2019,0,0,523
Marin,12/23/2020,730,2749,322,408,0,730,2749,0,0,730
Marin,12/24/2020,357,3106,159,198,0,357,3106,0,0,357
Marin,12/25/2020,27,3133,0,27,0,27,3133,0,0,27
Marin,12/26/2020,142,3275,93,49,0,142,3275,0,0,142
Marin,12/27/2020,92,3367,55,37,0,92,3367,0,0,92
Marin,12/28/2020,408,3775,99,309,0,408,3775,0,0,408
Marin,12/29/2020,401,4176,88,313,0,401,4176,0,0,401
Marin,12/30/2020,625,4801,388,237,0,625,4801,0,0,625
Marin,12/31/2020,197,4998,33,164,0,197,4998,0,0,197
Marin,1/1/2021,14,5012,5,9,0,14,5012,0,0,14
Marin,1/2/2021,103,5115,97,6,0,103,5115,0,0,103
Marin,1/3/2021,54,5169,36,18,0,51,5166,0,0,51
Marin,1/4/2021,292,5461,189,103,0,291,5456,1,1,291
Marin,1/5/2021,365,5826,222,143,0,322,5735,43,44,322
Marin,1/6/2021,816,6642,315,501,0,640,6199,176,220,640
Marin,1/7/2021,888,7530,501,387,0,541,6393,347,567,541
Marin,1/8/2021,971,8501,515,456,0,594,6611,376,943,594
Marin,1/9/2021,618,9119,223,395,0,487,6967,131,1074,487
Marin,1/10/2021,128,9247,99,29,0,54,6947,74,1148,54
Marin,1/11/2021,467,9714,326,141,0,248,6977,219,1367,249
Marin,1/12/2021,936,10650,539,397,0,566,7176,367,1734,566
Marin,1/13/2021,1175,11825,498,677,0,937,7875,238,1972,937
Marin,1/14/2021,1066,12891,318,748,0,916,8643,148,2120,916
Marin,1/15/2021,1152,14043,354,798,0,1022,9537,129,2249,1023
Marin,1/16/2021,1117,15160,914,203,0,1043,10506,74,2323,1043
Marin,1/17/2021,1233,16393,1114,119,0,1205,11687,27,2350,1208
Marin,1/18/2021,360,16753,159,201,0,309,11945,51,2401,309
Marin,1/19/2021,1155,17908,913,242,0,983,12757,171,2572,983
Marin,1/20/2021,1784,19692,1203,581,0,1054,13092,719,3291,1054
Marin,1/21/2021,1683,21375,1062,621,0,1331,14076,349,3640,1333
Marin,1/22/2021,1696,23071,1086,610,0,1529,15438,167,3807,1529
Marin,1/23/2021,1842,24913,1341,501,0,1757,17111,84,3891,1757
Marin,1/24/2021,613,25526,166,447,0,581,17660,32,3923,581
Marin,1/25/2021,1125,26651,227,898,0,693,17922,432,4355,694
Marin,1/26/2021,1503,28154,780,723,0,1124,18668,378,4733,1124
Marin,1/27/2021,1697,29851,871,826,0,1347,19668,348,5081,1348
Marin,1/28/2021,2070,31921,1064,1006,0,1808,21216,261,5342,1809
Marin,1/29/2021,2184,34105,1437,747,0,1982,23008,191,5533,1983
Marin,1/30/2021,1713,35818,899,814,0,1635,24566,78,5611,1636
Marin,1/31/2021,453,36271,316,137,0,428,24969,25,5636,428
Marin,2/1/2021,1087,37358,416,671,0,888,25659,199,5835,889
Marin,2/2/2021,1350,38708,462,888,0,724,25767,616,6451,724
Marin,2/3/2021,1779,40487,428,1351,0,1255,26499,523,6974,1255
Marin,2/4/2021,1534,42021,512,1022,0,934,26836,597,7571,934
Marin,2/5/2021,2174,44195,681,1493,0,1336,27338,834,8405,1336
Marin,2/6/2021,1426,45621,850,576,0,603,27119,822,9227,603
Marin,2/7/2021,1287,46908,1005,282,0,489,26811,797,10024,489
Marin,2/8/2021,1517,48425,753,764,0,725,26746,790,10814,725
Marin,2/9/2021,1782,50207,1122,660,0,837,26638,945,11759,837
Marin,2/10/2021,2335,52542,1489,846,0,1218,26742,1115,12874,1219
Marin,2/11/2021,2866,55408,1646,1220,0,1453,26789,1408,14282,1455
Marin,2/12/2021,3061,58469,1538,1523,0,1567,26864,1492,15774,1567
Marin,2/13/2021,2332,60801,1242,1090,0,1128,26790,1202,16976,1128
Marin,2/14/2021,810,61611,301,509,0,717,27415,93,17069,718
Marin,2/15/2021,1214,62825,356,858,0,833,27869,380,17449,834
Marin,2/16/2021,2463,65288,1056,1407,0,1503,28413,959,18408,1503
Marin,2/17/2021,2094,67382,938,1156,0,1087,28496,1005,19413,1088
Marin,2/18/2021,2411,69793,1577,834,0,1060,28206,1350,20763,1060
Marin,2/19/2021,2755,72548,2153,602,0,1219,27902,1524,22287,1220
Marin,2/20/2021,2566,75114,2112,454,0,1218,27777,1343,23630,1218
Marin,2/21/2021,1281,76395,1089,192,0,907,28314,370,24000,907
Marin,2/22/2021,1823,78218,1405,418,0,1212,28917,609,24609,1212
Marin,2/23/2021,2832,81050,1614,1218,0,1908,29911,915,25524,1909
Marin,2/24/2021,3505,84555,1605,1900,0,2253,30920,1245,26769,2254
Marin,2/25/2021,3925,88480,1808,2117,0,2768,32539,1150,27919,2769
Marin,2/26/2021,3480,91960,1879,1601,0,2528,34126,941,28860,2528
Marin,2/27/2021,2607,94567,1494,1113,0,1773,35070,831,29691,1775
Marin,2/28/2021,1379,95946,918,461,0,1043,35780,333,30024,1043
Marin,3/1/2021,2472,98418,1535,937,0,1662,36636,806,30830,1662
Marin,3/2/2021,2430,100848,1596,833,1,1683,37576,744,31574,1684
Marin,3/3/2021,4287,105135,2377,1908,2,2778,38852,1504,33078,2780
Marin,3/4/2021,3337,108472,1644,1692,1,2330,40186,1000,34078,2334
Marin,3/5/2021,3024,111496,1133,1879,12,1775,40727,1246,35324,1787
Marin,3/6/2021,3225,114721,2314,832,79,2653,42891,567,35891,2731
Marin,3/7/2021,1367,116088,1151,192,24,979,43509,385,36276,1003
Marin,3/8/2021,1872,117960,1367,388,117,1407,44571,462,36738,1524
Marin,3/9/2021,2098,120058,1217,774,107,1425,45432,671,37409,1532
Marin,3/10/2021,4396,124454,2457,1659,280,3173,47666,1220,38629,3454
Marin,3/11/2021,4551,129005,1869,2546,136,3262,49782,1282,39911,3398
Marin,3/12/2021,3967,132972,1534,2077,356,1559,49299,2397,42308,1914
Marin,3/13/2021,4089,137061,2855,1163,71,2418,50114,1669,43977,2484
Marin,3/14/2021,2271,139332,1095,1060,116,726,49413,1543,45520,842
Marin,3/15/2021,3226,142558,1761,1418,47,1220,48683,1996,47516,1266
Marin,3/16/2021,4294,146852,2308,1622,364,1520,47794,2771,50287,1882
Marin,3/17/2021,4174,151026,2263,1867,44,2054,47781,2110,52397,2097
Marin,3/18/2021,4471,155497,2248,2150,73,2242,47879,2215,54612,2313
Marin,3/19/2021,4455,159952,2273,1965,217,2432,48510,2017,56629,2648
Marin,3/20/2021,3576,163528,1981,1481,114,2035,49126,1534,58163,2150
Marin,3/21/2021,1530,165058,1126,379,25,797,49217,731,58894,822
Marin,3/22/2021,2461,167519,2129,167,165,987,48899,1470,60364,1152
Marin,3/23/2021,4233,171752,2190,1913,130,1938,48678,2289,62653,2068
Marin,3/24/2021,4414,176166,2894,1416,104,1796,47969,2607,65260,1898
Marin,3/25/2021,4640,180806,2831,1741,68,2269,47945,2359,67619,2335
Marin,3/26/2021,4282,185088,2323,1745,214,2419,48732,1846,69465,2633
Marin,3/27/2021,3686,188774,2647,1021,18,1143,47361,2532,71997,1161
Marin,3/28/2021,2374,191148,1718,650,6,1100,47198,1269,73266,1106
Marin,3/29/2021,2687,193835,2095,567,25,1191,46921,1493,74759,1216
Marin,3/30/2021,4650,198485,3648,969,33,3063,48433,1584,76343,3096
Marin,3/31/2021,5781,204266,4100,1632,49,2576,47863,3195,79538,2625
Marin,4/1/2021,4383,208649,2260,1872,251,2108,47955,2267,81805,2359
Marin,4/2/2021,3674,212323,1820,1491,363,1955,48560,1713,83518,2318
Marin,4/3/2021,3831,216154,2519,943,369,1462,48032,2359,85877,1831
Marin,4/4/2021,1632,217786,1227,201,204,1193,48991,438,86315,1397
Marin,4/5/2021,2183,219969,1516,296,371,1258,49696,922,87237,1627
Marin,4/6/2021,3930,223899,2102,1281,547,2185,50686,1739,88976,2729
Marin,4/7/2021,3896,227795,1965,1293,638,1415,50265,2474,91450,2053
Marin,4/8/2021,4986,232781,1950,2430,606,2278,50442,2701,94151,2878
Marin,4/9/2021,3933,236714,1529,1681,723,1296,49825,2633,96784,2016
Marin,4/10/2021,3176,239890,1460,1283,433,1429,49948,1737,98521,1860
Marin,4/11/2021,1055,240945,801,93,161,474,50002,580,99101,634
Marin,4/12/2021,1704,242649,1228,340,136,919,50276,782,99883,1056
Marin,4/13/2021,3707,246356,2272,1428,7,1350,49286,2347,102230,1357
Marin,4/14/2021,4142,250498,2477,1663,2,1702,48556,2433,104663,1703
Marin,4/15/2021,5538,256036,3924,1614,0,3178,49389,2346,107009,3179
Marin,4/16/2021,4223,260259,2222,1998,3,2062,49305,2149,109158,2065
Marin,4/17/2021,3514,263773,2151,1363,0,1758,49312,1751,110909,1758
Marin,4/18/2021,3201,266974,3100,101,0,2562,51238,636,111545,2562
Marin,4/19/2021,2003,268977,1834,169,0,1158,51556,842,112387,1160
Marin,4/20/2021,3692,272669,2554,1138,0,1482,50833,2205,114592,1482
Marin,4/21/2021,4002,276671,2943,1057,2,1379,49605,2608,117200,1380
Marin,4/22/2021,3807,280478,2851,956,0,1316,48438,2484,119684,1317
Marin,4/23/2021,716,281194,257,459,0,269,48260,447,120131,269
Mariposa,12/17/2020,37,37,37,0,0,39,39,0,0,39
Mariposa,12/18/2020,56,93,56,0,0,57,96,0,0,57
Mariposa,12/20/2020,2,95,2,0,0,2,98,0,0,2
Mariposa,12/21/2020,47,142,47,0,0,52,150,0,0,52
Mariposa,12/22/2020,5,147,5,0,0,5,155,0,0,5
Mariposa,12/23/2020,17,164,17,0,0,17,172,0,0,17
Mariposa,12/24/2020,1,165,0,1,0,0,172,0,0,0
Mariposa,12/26/2020,1,166,1,0,0,1,173,0,0,1
Mariposa,12/27/2020,1,167,0,1,0,1,174,0,0,1
Mariposa,12/28/2020,6,173,3,3,0,6,180,0,0,6
Mariposa,12/29/2020,33,206,3,30,0,33,213,0,0,33
Mariposa,12/30/2020,25,231,4,21,0,25,238,0,0,25
Mariposa,12/31/2020,17,248,0,17,0,17,255,0,0,17
Mariposa,1/2/2021,2,250,2,0,0,2,257,0,0,2
Mariposa,1/4/2021,8,258,1,7,0,8,265,0,0,8
Mariposa,1/5/2021,24,282,14,10,0,14,269,10,10,14
Mariposa,1/6/2021,6,288,3,3,0,3,269,3,13,3
Mariposa,1/7/2021,52,340,47,5,0,5,227,47,60,5
Mariposa,1/8/2021,109,449,80,29,0,34,186,75,135,34
Mariposa,1/9/2021,1,450,0,1,0,1,187,0,135,1
Mariposa,1/11/2021,31,481,10,21,0,23,202,8,143,23
Mariposa,1/12/2021,19,500,4,15,0,15,213,4,147,15
Mariposa,1/13/2021,21,521,4,17,0,18,228,3,150,18
Mariposa,1/14/2021,73,594,7,66,0,67,289,6,156,67
Mariposa,1/15/2021,66,660,26,40,0,56,335,10,166,56
Mariposa,1/16/2021,14,674,2,12,0,13,347,1,167,13
Mariposa,1/17/2021,2,676,0,2,0,2,349,0,167,2
Mariposa,1/18/2021,3,679,3,0,0,1,348,2,169,1
Mariposa,1/19/2021,8,687,4,4,0,5,351,2,171,5
Mariposa,1/20/2021,23,710,1,22,0,22,372,1,172,22
Mariposa,1/21/2021,64,774,8,56,0,59,426,5,177,59
Mariposa,1/22/2021,55,829,2,53,0,55,481,0,177,55
Mariposa,1/23/2021,116,945,2,114,0,115,595,1,178,115
Mariposa,1/24/2021,2,947,2,0,0,2,597,0,178,2
Mariposa,1/25/2021,4,951,1,3,0,0,593,4,182,0
Mariposa,1/26/2021,36,987,4,32,0,4,569,32,214,8
Mariposa,1/27/2021,22,1009,1,21,0,13,573,9,223,13
Mariposa,1/28/2021,127,1136,3,124,0,113,673,13,236,113
Mariposa,1/29/2021,84,1220,22,62,0,83,755,1,237,83
Mariposa,1/30/2021,9,1229,1,8,0,8,762,1,238,8
Mariposa,1/31/2021,1,1230,0,1,0,1,763,0,238,1
Mariposa,2/1/2021,87,1317,30,57,0,66,808,21,259,66
Mariposa,2/2/2021,15,1332,3,12,0,9,811,6,265,9
Mariposa,2/3/2021,20,1352,1,19,0,14,819,6,271,14
Mariposa,2/4/2021,91,1443,8,83,0,86,902,4,275,87
Mariposa,2/5/2021,189,1632,5,184,0,162,1037,27,302,162
Mariposa,2/6/2021,11,1643,4,7,0,10,1046,1,303,10
Mariposa,2/8/2021,40,1683,2,38,0,21,1048,19,322,21
Mariposa,2/9/2021,43,1726,25,18,0,37,1079,6,328,37
Mariposa,2/10/2021,28,1754,5,23,0,17,1092,10,338,23
Mariposa,2/11/2021,373,2127,5,368,0,360,1441,13,351,362
Mariposa,2/12/2021,183,2310,7,176,0,140,1538,43,394,140
Mariposa,2/13/2021,11,2321,3,8,0,9,1545,2,396,9
Mariposa,2/14/2021,7,2328,4,3,0,5,1548,2,398,5
Mariposa,2/15/2021,8,2336,2,6,0,7,1554,1,399,7
Mariposa,2/16/2021,57,2393,34,23,0,34,1565,23,422,34
Mariposa,2/17/2021,35,2428,8,27,0,27,1585,7,429,27
Mariposa,2/18/2021,55,2483,7,48,0,20,1570,35,464,20
Mariposa,2/19/2021,82,2565,3,79,0,77,1642,5,469,77
Mariposa,2/20/2021,251,2816,4,247,0,222,1836,28,497,222
Mariposa,2/21/2021,233,3049,2,231,0,232,2067,1,498,232
Mariposa,2/22/2021,24,3073,7,17,0,21,2085,3,501,21
Mariposa,2/23/2021,42,3115,36,6,0,25,2093,17,518,25
Mariposa,2/24/2021,19,3134,3,16,0,7,2089,11,529,7
Mariposa,2/25/2021,17,3151,8,9,0,11,2094,6,535,11
Mariposa,2/26/2021,421,3572,6,415,0,360,2394,61,596,361
Mariposa,2/27/2021,171,3743,5,166,0,160,2543,11,607,160
Mariposa,2/28/2021,2,3745,1,1,0,0,2541,2,609,0
Mariposa,3/1/2021,81,3826,25,56,0,16,2493,64,673,16
Mariposa,3/2/2021,20,3846,13,7,0,11,2495,9,682,11
Mariposa,3/3/2021,71,3917,5,66,0,66,2557,5,687,67
Mariposa,3/4/2021,31,3948,8,23,0,20,2566,11,698,20
Mariposa,3/5/2021,50,3998,8,42,0,37,2594,13,711,41
Mariposa,3/6/2021,15,4013,6,9,0,7,2593,8,719,7
Mariposa,3/7/2021,1,4014,1,0,0,0,2592,1,720,0
Mariposa,3/8/2021,38,4052,4,23,11,9,2583,29,749,20
Mariposa,3/9/2021,47,4099,18,19,10,16,2578,31,780,26
Mariposa,3/10/2021,30,4129,10,10,10,10,2578,20,800,20
Mariposa,3/11/2021,464,4593,6,440,18,224,2584,239,1039,245
Mariposa,3/12/2021,252,4845,6,218,28,112,2583,140,1179,139
Mariposa,3/13/2021,33,4878,7,11,15,12,2588,21,1200,26
Mariposa,3/14/2021,17,4895,2,4,11,3,2588,14,1214,14
Mariposa,3/15/2021,76,4971,7,31,38,31,2612,45,1259,69
Mariposa,3/16/2021,82,5053,32,15,35,24,2613,58,1317,59
Mariposa,3/17/2021,72,5125,11,53,8,52,2654,19,1336,60
Mariposa,3/18/2021,66,5191,15,41,10,41,2680,25,1361,51
Mariposa,3/19/2021,335,5526,8,322,5,301,2952,34,1395,306
Mariposa,3/20/2021,424,5950,5,417,2,48,2627,376,1771,51
Mariposa,3/21/2021,13,5963,8,4,1,9,2633,4,1775,10
Mariposa,3/22/2021,36,5999,7,21,8,25,2656,11,1786,34
Mariposa,3/23/2021,52,6051,32,10,10,32,2678,20,1806,42
Mariposa,3/24/2021,56,6107,5,49,2,51,2726,5,1811,53
Mariposa,3/25/2021,73,6180,15,50,8,53,2767,20,1831,61
Mariposa,3/26/2021,486,6666,9,476,1,250,2782,236,2067,251
Mariposa,3/27/2021,225,6891,8,217,0,90,2738,135,2202,91
Mariposa,3/28/2021,6,6897,1,2,3,2,2739,4,2206,5
Mariposa,3/29/2021,18,6915,5,13,0,11,2743,7,2213,11
Mariposa,3/30/2021,38,6953,14,8,16,15,2751,23,2236,31
Mariposa,3/31/2021,86,7039,17,68,1,71,2808,15,2251,72
Mariposa,4/1/2021,21,7060,8,12,1,8,2804,13,2264,9
Mariposa,4/2/2021,47,7107,10,35,2,16,2792,30,2294,18
Mariposa,4/3/2021,9,7116,6,3,0,4,2791,5,2299,4
Mariposa,4/4/2021,2,7118,1,0,1,0,2790,2,2301,1
Mariposa,4/5/2021,30,7148,22,5,3,14,2791,16,2317,17
Mariposa,4/6/2021,43,7191,20,7,16,13,2791,29,2346,29
Mariposa,4/7/2021,31,7222,5,7,19,2,2783,29,2375,21
Mariposa,4/8/2021,50,7272,13,18,19,16,2786,32,2407,35
Mariposa,4/9/2021,33,7305,9,12,12,10,2785,23,2430,22
Mariposa,4/10/2021,15,7320,1,4,10,4,2787,11,2441,13
Mariposa,4/11/2021,8,7328,4,2,2,1,2783,7,2448,3
Mariposa,4/12/2021,36,7364,10,24,2,8,2765,28,2476,10
Mariposa,4/13/2021,55,7419,46,9,0,36,2782,19,2495,36
Mariposa,4/14/2021,13,7432,6,7,0,7,2783,6,2501,7
Mariposa,4/15/2021,28,7460,16,12,0,14,2786,11,2512,14
Mariposa,4/16/2021,58,7518,12,46,0,25,2778,33,2545,25
Mariposa,4/17/2021,11,7529,6,5,0,8,2783,3,2548,8
Mariposa,4/18/2021,6,7535,0,6,0,3,2783,3,2551,3
Mariposa,4/19/2021,54,7589,24,30,0,29,2788,24,2575,29
Mariposa,4/20/2021,62,7651,49,13,0,40,2809,19,2594,40
Mariposa,4/21/2021,20,7671,12,8,0,9,2808,10,2604,9
Mariposa,4/22/2021,23,7694,8,15,0,18,2822,4,2608,18
Mariposa,4/23/2021,121,7815,66,55,0,111,2923,10,2618,111
Mendocino,12/17/2020,70,70,70,0,0,70,70,0,0,70
Mendocino,12/18/2020,85,155,84,1,0,84,154,0,0,84
Mendocino,12/19/2020,4,159,4,0,0,4,158,0,0,4
Mendocino,12/20/2020,7,166,7,0,0,7,165,0,0,7
Mendocino,12/21/2020,244,410,244,0,0,77,242,0,0,77
Mendocino,12/22/2020,250,660,189,61,0,250,492,0,0,250
Mendocino,12/23/2020,270,930,47,223,0,269,761,0,0,269
Mendocino,12/24/2020,49,979,8,41,0,49,810,0,0,49
Mendocino,12/25/2020,1,980,0,1,0,1,811,0,0,1
Mendocino,12/26/2020,2,982,2,0,0,2,813,0,0,2
Mendocino,12/27/2020,1,983,0,1,0,1,814,0,0,1
Mendocino,12/28/2020,74,1057,9,65,0,74,888,0,0,74
Mendocino,12/29/2020,122,1179,61,61,0,122,1010,0,0,122
Mendocino,12/30/2020,123,1302,68,55,0,123,1133,0,0,123
Mendocino,12/31/2020,130,1432,95,35,0,130,1263,0,0,130
Mendocino,1/1/2021,7,1439,5,2,0,7,1270,0,0,7
Mendocino,1/2/2021,1,1440,1,0,0,1,1271,0,0,1
Mendocino,1/4/2021,840,2280,19,821,0,840,2111,0,0,840
Mendocino,1/5/2021,71,2351,35,36,0,58,2156,13,13,58
Mendocino,1/6/2021,151,2502,129,22,0,141,2287,10,23,141
Mendocino,1/7/2021,355,2857,235,120,0,292,2516,63,86,292
Mendocino,1/8/2021,95,2952,82,13,0,41,2504,54,140,42
Mendocino,1/9/2021,10,2962,6,4,0,8,2510,2,142,8
Mendocino,1/10/2021,8,2970,8,0,0,1,2504,7,149,1
Mendocino,1/11/2021,101,3071,92,9,0,43,2490,57,206,43
Mendocino,1/12/2021,386,3457,376,10,0,270,2644,116,322,270
Mendocino,1/13/2021,483,3940,145,338,0,442,3048,39,361,443
Mendocino,1/14/2021,636,4576,20,616,0,627,3666,9,370,627
Mendocino,1/15/2021,1856,6432,858,998,0,1852,5514,4,374,1852
Mendocino,1/16/2021,791,7223,50,741,0,789,6301,2,376,789
Mendocino,1/17/2021,554,7777,1,553,0,553,6853,1,377,553
Mendocino,1/18/2021,488,8265,463,25,0,476,7317,12,389,476
Mendocino,1/19/2021,332,8597,147,185,0,156,7297,176,565,156
Mendocino,1/20/2021,552,9149,405,147,0,446,7640,104,669,447
Mendocino,1/21/2021,535,9684,222,313,0,351,7808,183,852,351
Mendocino,1/22/2021,149,9833,58,91,0,110,7879,39,891,110
Mendocino,1/23/2021,155,9988,83,72,0,149,8022,6,897,149
Mendocino,1/24/2021,5,9993,3,2,0,5,8027,0,897,5
Mendocino,1/25/2021,191,10184,18,173,0,121,8078,70,967,121
Mendocino,1/26/2021,157,10341,57,100,0,96,8113,61,1028,96
Mendocino,1/27/2021,432,10773,362,70,0,174,8036,251,1279,174
Mendocino,1/28/2021,585,11358,521,64,0,491,8433,94,1373,491
Mendocino,1/29/2021,391,11749,350,41,0,362,8767,29,1402,363
Mendocino,1/30/2021,48,11797,30,18,0,41,8801,7,1409,41
Mendocino,1/31/2021,273,12070,2,271,0,3,8534,270,1679,3
Mendocino,2/1/2021,381,12451,53,328,0,58,8269,323,2002,58
Mendocino,2/2/2021,720,13171,501,219,0,362,8273,358,2360,362
Mendocino,2/3/2021,391,13562,206,185,0,221,8326,168,2528,221
Mendocino,2/4/2021,624,14186,528,96,0,500,8702,124,2652,500
Mendocino,2/5/2021,1298,15484,1211,87,0,584,8573,713,3365,584
Mendocino,2/6/2021,559,16043,158,401,0,544,9102,15,3380,544
Mendocino,2/7/2021,32,16075,28,4,0,32,9134,0,3380,32
Mendocino,2/8/2021,745,16820,714,31,0,284,8957,461,3841,284
Mendocino,2/9/2021,141,16961,58,83,0,89,8994,52,3893,89
Mendocino,2/10/2021,1480,18441,920,560,0,740,9000,734,4627,740
Mendocino,2/11/2021,1133,19574,208,925,0,284,8435,849,5476,284
Mendocino,2/12/2021,1401,20975,158,1243,0,636,8307,764,6240,636
Mendocino,2/13/2021,496,21471,12,484,0,103,8023,392,6632,108
Mendocino,2/14/2021,694,22165,3,691,0,134,7597,560,7192,134
Mendocino,2/15/2021,329,22494,43,286,0,174,7616,155,7347,174
Mendocino,2/16/2021,201,22695,51,150,0,131,7677,70,7417,131
Mendocino,2/17/2021,1349,24044,1187,162,0,877,8084,470,7887,877
Mendocino,2/18/2021,1780,25824,639,1141,0,1215,8735,564,8451,1215
Mendocino,2/19/2021,749,26573,146,603,0,610,9206,139,8590,610
Mendocino,2/20/2021,570,27143,544,26,0,540,9718,28,8618,540
Mendocino,2/21/2021,326,27469,6,320,0,314,10021,11,8629,314
Mendocino,2/22/2021,162,27631,30,132,0,70,10000,91,8720,70
Mendocino,2/23/2021,672,28303,660,12,0,611,10551,60,8780,611
Mendocino,2/24/2021,1838,30141,1759,79,0,1429,11577,405,9185,1431
Mendocino,2/25/2021,1702,31843,531,1171,0,1284,12444,417,9602,1284
Mendocino,2/26/2021,1400,33243,747,653,0,1037,13120,361,9963,1037
Mendocino,2/27/2021,199,33442,151,48,0,76,13074,122,10085,76
Mendocino,2/28/2021,34,33476,12,22,0,23,13086,11,10096,23
Mendocino,3/1/2021,576,34052,533,43,0,539,13588,37,10133,539
Mendocino,3/2/2021,70,34122,24,46,0,41,13601,28,10161,41
Mendocino,3/3/2021,1703,35825,1326,377,0,1073,14046,628,10789,1073
Mendocino,3/4/2021,1768,37593,146,1622,0,1551,15383,215,11004,1552
Mendocino,3/5/2021,206,37799,145,52,9,117,15422,87,11091,126
Mendocino,3/6/2021,241,38040,20,196,25,201,15609,39,11130,226
Mendocino,3/7/2021,503,38543,6,477,20,116,15358,386,11516,135
Mendocino,3/8/2021,124,38667,29,59,36,64,15400,58,11574,100
Mendocino,3/9/2021,441,39108,224,176,41,346,15692,95,11669,387
Mendocino,3/10/2021,1107,40215,978,64,65,267,15190,837,12506,335
Mendocino,3/11/2021,820,41035,611,156,53,394,15213,424,12930,447
Mendocino,3/12/2021,2015,43050,1029,892,94,1210,15719,798,13728,1304
Mendocino,3/13/2021,653,43703,524,72,57,96,15319,553,14281,153
Mendocino,3/14/2021,103,43806,2,94,7,11,15248,89,14370,18
Mendocino,3/15/2021,596,44402,51,488,57,208,15126,387,14757,265
Mendocino,3/16/2021,571,44973,374,152,45,139,14880,430,15187,184
Mendocino,3/17/2021,1562,46535,1359,56,147,214,13903,1345,16532,368
Mendocino,3/18/2021,1307,47842,248,1021,38,284,13209,1015,17547,321
Mendocino,3/19/2021,1756,49598,857,838,61,334,12188,1418,18965,397
Mendocino,3/20/2021,69,49667,11,37,21,13,12166,56,19021,34
Mendocino,3/21/2021,8,49675,1,2,5,3,12169,5,19026,8
Mendocino,3/22/2021,624,50299,580,15,29,146,11869,474,19500,174
Mendocino,3/23/2021,166,50465,33,103,30,116,11965,50,19550,146
Mendocino,3/24/2021,910,51375,839,24,47,115,11334,793,20343,162
Mendocino,3/25/2021,1984,53359,50,1915,19,173,9717,1808,22151,191
Mendocino,3/26/2021,505,53864,357,123,25,323,9883,182,22333,348
Mendocino,3/27/2021,141,54005,12,118,11,82,9917,58,22391,92
Mendocino,3/28/2021,26,54031,5,17,4,4,9903,22,22413,8
Mendocino,3/29/2021,186,54217,97,47,42,95,9949,91,22504,137
Mendocino,3/30/2021,681,54898,596,48,37,417,10140,263,22767,454
Mendocino,3/31/2021,862,55760,270,533,59,409,10157,451,23218,468
Mendocino,4/1/2021,1703,57463,393,1232,78,378,9294,1318,24536,455
Mendocino,4/2/2021,1282,58745,1054,155,73,223,8534,1056,25592,296
Mendocino,4/3/2021,703,59448,7,675,21,87,8030,612,26204,108
Mendocino,4/4/2021,69,59517,34,29,6,54,8075,15,26219,60
Mendocino,4/5/2021,209,59726,141,44,24,129,8146,80,26299,151
Mendocino,4/6/2021,381,60107,121,179,81,106,8058,275,26574,187
Mendocino,4/7/2021,473,60580,167,63,243,114,8057,357,26931,356
Mendocino,4/8/2021,1482,62062,910,459,113,996,8686,481,27412,1110
Mendocino,4/9/2021,750,62812,426,170,154,395,8881,354,27766,549
Mendocino,4/10/2021,141,62953,90,6,45,86,8957,55,27821,131
Mendocino,4/11/2021,121,63074,47,18,56,58,9008,63,27884,114
Mendocino,4/12/2021,615,63689,510,46,59,411,9274,204,28088,470
Mendocino,4/13/2021,286,63975,224,62,0,220,9428,66,28154,220
Mendocino,4/14/2021,509,64484,420,89,0,408,9735,101,28255,408
Mendocino,4/15/2021,652,65136,325,327,0,394,9874,255,28510,394
Mendocino,4/16/2021,120,65256,48,72,0,72,9899,47,28557,72
Mendocino,4/17/2021,57,65313,11,46,0,47,9937,9,28566,47
Mendocino,4/18/2021,7,65320,2,5,0,4,9938,3,28569,4
Mendocino,4/19/2021,513,65833,488,25,0,433,10292,79,28648,433
Mendocino,4/20/2021,390,66223,263,127,0,262,10426,128,28776,262
Mendocino,4/21/2021,163,66386,111,52,0,108,10480,54,28830,108
Mendocino,4/22/2021,432,66818,283,149,0,313,10675,118,28948,313
Mendocino,4/23/2021,588,67406,530,58,0,528,11144,59,29007,528
Merced,12/16/2020,3,3,3,0,0,3,3,0,0,3
Merced,12/17/2020,5,8,5,0,0,5,8,0,0,5
Merced,12/18/2020,145,153,145,0,0,145,153,0,0,145
Merced,12/19/2020,39,192,39,0,0,39,192,0,0,39
Merced,12/20/2020,17,209,17,0,0,17,209,0,0,17
Merced,12/21/2020,126,335,123,3,0,126,335,0,0,126
Merced,12/22/2020,153,488,153,0,0,153,488,0,0,153
Merced,12/23/2020,248,736,242,6,0,248,736,0,0,248
Merced,12/24/2020,71,807,71,0,0,71,807,0,0,71
Merced,12/25/2020,4,811,4,0,0,4,811,0,0,4
Merced,12/26/2020,6,817,3,3,0,6,817,0,0,6
Merced,12/27/2020,12,829,11,1,0,12,829,0,0,12
Merced,12/28/2020,122,951,98,24,0,122,951,0,0,122
Merced,12/29/2020,178,1129,123,55,0,178,1129,0,0,178
Merced,12/30/2020,215,1344,89,126,0,215,1344,0,0,215
Merced,12/31/2020,101,1445,34,67,0,101,1445,0,0,101
Merced,1/1/2021,2,1447,0,2,0,2,1447,0,0,2
Merced,1/2/2021,127,1574,117,10,0,127,1574,0,0,127
Merced,1/3/2021,9,1583,5,4,0,9,1583,0,0,9
Merced,1/4/2021,79,1662,41,38,0,79,1662,0,0,79
Merced,1/5/2021,317,1979,230,87,0,311,1969,6,6,313
Merced,1/6/2021,247,2226,98,149,0,241,2204,6,12,241
Merced,1/7/2021,183,2409,79,104,0,173,2366,11,23,173
Merced,1/8/2021,524,2933,393,131,0,372,2587,151,174,372
Merced,1/9/2021,23,2956,10,13,0,17,2598,6,180,17
Merced,1/10/2021,10,2966,6,4,0,6,2600,4,184,6
Merced,1/11/2021,224,3190,167,57,0,101,2579,123,307,102
Merced,1/12/2021,279,3469,156,123,0,229,2757,51,358,229
Merced,1/13/2021,370,3839,173,197,0,220,2829,150,508,222
Merced,1/14/2021,324,4163,200,124,0,159,2825,164,672,160
Merced,1/15/2021,564,4727,125,439,0,526,3314,39,711,528
Merced,1/16/2021,201,4928,122,79,0,196,3505,5,716,196
Merced,1/17/2021,49,4977,12,37,0,48,3552,1,717,48
Merced,1/18/2021,258,5235,126,132,0,236,3769,22,739,239
Merced,1/19/2021,701,5936,579,122,0,531,4134,170,909,535
Merced,1/20/2021,571,6507,466,105,0,515,4596,56,965,518
Merced,1/21/2021,1004,7511,644,360,0,905,5405,99,1064,908
Merced,1/22/2021,1297,8808,681,616,0,1271,6662,26,1090,1283
Merced,1/23/2021,305,9113,183,122,0,200,6757,105,1195,200
Merced,1/24/2021,32,9145,14,18,0,23,6772,8,1203,23
Merced,1/25/2021,727,9872,242,485,0,667,7380,59,1262,667
Merced,1/26/2021,905,10777,477,428,0,668,7839,210,1472,669
Merced,1/27/2021,976,11753,583,393,0,814,8493,160,1632,814
Merced,1/28/2021,1135,12888,591,544,0,1016,9391,119,1751,1017
Merced,1/29/2021,845,13733,322,523,0,601,9757,237,1988,603
Merced,1/30/2021,258,13991,27,231,0,243,9985,15,2003,243
Merced,1/31/2021,45,14036,10,35,0,44,10028,1,2004,44
Merced,2/1/2021,371,14407,52,319,0,324,10306,46,2050,324
Merced,2/2/2021,290,14697,178,112,0,171,10361,117,2167,172
Merced,2/3/2021,349,15046,71,278,0,169,10350,180,2347,169
Merced,2/4/2021,369,15415,146,223,0,241,10465,127,2474,242
Merced,2/5/2021,515,15930,174,341,0,275,10503,239,2713,277
Merced,2/6/2021,388,16318,218,170,0,245,10607,142,2855,246
Merced,2/7/2021,20,16338,12,8,0,13,10613,7,2862,13
Merced,2/8/2021,279,16617,197,82,0,171,10677,108,2970,172
Merced,2/9/2021,1212,17829,953,259,0,777,11028,427,3397,778
Merced,2/10/2021,1848,19677,1431,417,0,1271,11730,569,3966,1271
Merced,2/11/2021,2491,22168,1998,493,0,1809,12865,674,4640,1809
Merced,2/12/2021,1709,23877,1011,698,0,752,12669,949,5589,753
Merced,2/13/2021,355,24232,200,155,0,262,12841,92,5681,264
Merced,2/14/2021,116,24348,26,90,0,95,12916,21,5702,96
Merced,2/15/2021,272,24620,40,232,0,169,12988,98,5800,170
Merced,2/16/2021,1209,25829,841,368,0,839,13476,353,6153,841
Merced,2/17/2021,1868,27697,1625,243,0,1308,14240,546,6699,1310
Merced,2/18/2021,1197,28894,808,389,0,395,13853,782,7481,395
Merced,2/19/2021,1251,30145,405,846,0,528,13666,717,8198,530
Merced,2/20/2021,274,30419,31,243,0,140,13674,132,8330,140
Merced,2/21/2021,73,30492,59,14,0,29,13659,44,8374,29
Merced,2/22/2021,825,31317,292,533,0,480,13795,344,8718,480
Merced,2/23/2021,1070,32387,414,656,0,631,13991,435,9153,631
Merced,2/24/2021,812,33199,300,512,0,443,14075,360,9513,444
Merced,2/25/2021,1749,34948,860,889,0,1299,14929,447,9960,1301
Merced,2/26/2021,2125,37073,1359,766,0,1717,16241,406,10366,1718
Merced,2/27/2021,2500,39573,1086,1413,1,2216,18174,283,10649,2216
Merced,2/28/2021,298,39871,71,227,0,251,18381,44,10693,251
Merced,3/1/2021,1106,40977,277,829,0,771,18824,328,11021,771
Merced,3/2/2021,1703,42680,863,839,1,1320,19767,378,11399,1321
Merced,3/3/2021,2196,44876,1713,482,1,1445,20476,737,12136,1446
Merced,3/4/2021,2872,47748,2262,608,2,1908,21439,947,13083,1910
Merced,3/5/2021,2051,49799,1183,845,23,1515,22454,524,13607,1539
Merced,3/6/2021,1148,50947,647,479,22,894,23117,253,13860,916
Merced,3/7/2021,224,51171,62,137,25,195,23308,29,13889,220
Merced,3/8/2021,1197,52368,601,531,65,986,24148,210,14099,1050
Merced,3/9/2021,1673,54041,992,575,106,1086,24759,582,14681,1193
Merced,3/10/2021,2676,56717,1855,621,200,1610,25520,1054,15735,1815
Merced,3/11/2021,1823,58540,616,1001,206,1216,26369,596,16331,1445
Merced,3/12/2021,2178,60718,888,1021,269,1471,27417,704,17035,1752
Merced,3/13/2021,720,61438,309,169,242,414,27776,298,17333,657
Merced,3/14/2021,248,61686,135,83,30,150,27860,97,17430,181
Merced,3/15/2021,1484,63170,489,742,253,971,28578,505,17935,1223
Merced,3/16/2021,1420,64590,679,518,223,941,29270,470,18405,1162
Merced,3/17/2021,1925,66515,1028,719,178,1484,30500,434,18839,1664
Merced,3/18/2021,1982,68497,1123,713,146,1369,31421,605,19444,1526
Merced,3/19/2021,2650,71147,1443,1014,193,1378,31730,1264,20708,1573
Merced,3/20/2021,2326,73473,1416,521,389,904,31611,1416,22124,1297
Merced,3/21/2021,556,74029,342,201,13,437,31944,119,22243,452
Merced,3/22/2021,1260,75289,627,557,76,890,32548,363,22606,967
Merced,3/23/2021,1807,77096,1089,654,64,1334,33477,470,23076,1399
Merced,3/24/2021,1279,78375,761,484,34,888,34014,384,23460,921
Merced,3/25/2021,3281,81656,2253,1006,22,2061,34887,1212,24672,2085
Merced,3/26/2021,1902,83558,1068,800,34,877,34781,1017,25689,911
Merced,3/27/2021,2814,86372,1567,1190,57,1189,34412,1615,27304,1246
Merced,3/28/2021,508,86880,210,291,7,211,34336,296,27600,220
Merced,3/29/2021,1538,88418,519,858,161,655,34279,877,28477,820
Merced,3/30/2021,2062,90480,783,1220,59,922,34125,1135,29612,981
Merced,3/31/2021,2096,92576,1394,668,34,937,33951,1145,30757,971
Merced,4/1/2021,2000,94576,886,1007,107,844,33755,1149,31906,953
Merced,4/2/2021,2242,96818,606,1234,402,705,33343,1522,33428,1110
Merced,4/3/2021,727,97545,342,375,10,332,33293,394,33822,344
Merced,4/4/2021,365,97910,141,220,4,141,33217,223,34045,147
Merced,4/5/2021,1206,99116,552,443,211,395,33013,809,34854,605
Merced,4/6/2021,2201,101317,710,676,815,716,33063,1482,36336,1532
Merced,4/7/2021,1594,102911,850,637,107,561,32709,1023,37359,669
Merced,4/8/2021,2176,105087,1099,864,213,741,32256,1405,38764,952
Merced,4/9/2021,1661,106748,462,620,579,560,32313,1084,39848,1141
Merced,4/10/2021,657,107405,342,132,183,168,32178,485,40333,350
Merced,4/11/2021,487,107892,279,73,135,148,32125,337,40670,284
Merced,4/12/2021,1336,109228,856,362,118,777,32494,526,41196,895
Merced,4/13/2021,1996,111224,1437,556,3,934,32452,983,42179,941
Merced,4/14/2021,1920,113144,1106,814,0,892,32443,903,43082,894
Merced,4/15/2021,2982,116126,1954,1028,0,950,31585,1812,44894,954
Merced,4/16/2021,2282,118408,1134,1148,0,910,31214,1281,46175,910
Merced,4/17/2021,1231,119639,779,452,0,384,30756,842,47017,384
Merced,4/18/2021,468,120107,249,219,0,192,30698,250,47267,192
Merced,4/19/2021,1240,121347,731,509,0,687,30927,458,47725,687
Merced,4/20/2021,1303,122650,729,574,0,754,31200,481,48206,754
Merced,4/21/2021,1334,123984,865,469,0,708,31393,515,48721,708
Merced,4/22/2021,1424,125408,667,757,0,712,31462,643,49364,712
Merced,4/23/2021,661,126069,95,566,0,387,31586,263,49627,387
Modoc,12/16/2020,1,1,1,0,0,1,1,0,0,1
Modoc,12/21/2020,100,101,100,0,0,100,101,0,0,100
Modoc,12/22/2020,14,115,14,0,0,14,115,0,0,14
Modoc,12/23/2020,4,119,4,0,0,4,119,0,0,4
Modoc,12/24/2020,1,120,1,0,0,1,120,0,0,1
Modoc,12/28/2020,2,122,2,0,0,2,122,0,0,2
Modoc,12/29/2020,10,132,1,9,0,10,132,0,0,10
Modoc,12/30/2020,7,139,0,7,0,7,139,0,0,7
Modoc,1/2/2021,2,141,0,2,0,2,141,0,0,2
Modoc,1/4/2021,8,149,0,8,0,8,149,0,0,8
Modoc,1/5/2021,2,151,1,1,0,2,151,0,0,2
Modoc,1/6/2021,3,154,2,1,0,2,152,1,1,2
Modoc,1/7/2021,72,226,0,72,0,72,224,0,1,72
Modoc,1/8/2021,105,331,0,105,0,105,329,0,1,105
Modoc,1/10/2021,1,332,1,0,0,0,328,1,2,0
Modoc,1/11/2021,91,423,82,9,0,19,275,72,74,19
Modoc,1/12/2021,94,517,25,69,0,68,317,26,100,68
Modoc,1/13/2021,24,541,4,20,0,22,337,2,102,22
Modoc,1/14/2021,129,670,6,123,0,124,456,5,107,124
Modoc,1/15/2021,6,676,1,5,0,6,462,0,107,6
Modoc,1/16/2021,1,677,1,0,0,1,463,0,107,1
Modoc,1/18/2021,1,678,1,0,0,1,464,0,107,1
Modoc,1/19/2021,5,683,3,2,0,3,465,2,109,3
Modoc,1/20/2021,11,694,1,10,0,11,476,0,109,11
Modoc,1/21/2021,157,851,2,155,0,157,633,0,109,157
Modoc,1/22/2021,2,853,0,2,0,2,635,0,109,2
Modoc,1/25/2021,11,864,0,11,0,11,646,0,109,11
Modoc,1/26/2021,65,929,1,64,0,65,711,0,109,65
Modoc,1/27/2021,41,970,2,39,0,25,720,16,125,25
Modoc,1/28/2021,144,1114,1,143,0,144,864,0,125,144
Modoc,1/29/2021,3,1117,1,2,0,3,867,0,125,3
Modoc,2/1/2021,25,1142,12,13,0,11,864,14,139,11
Modoc,2/2/2021,170,1312,2,168,0,167,1028,3,142,167
Modoc,2/3/2021,18,1330,13,5,0,11,1032,7,149,11
Modoc,2/4/2021,155,1485,4,151,0,27,931,128,277,27
Modoc,2/5/2021,4,1489,3,1,0,3,933,1,278,3
Modoc,2/8/2021,9,1498,2,7,0,8,940,1,279,8
Modoc,2/9/2021,198,1696,13,185,0,66,874,132,411,66
Modoc,2/10/2021,5,1701,2,3,0,4,877,1,412,4
Modoc,2/11/2021,201,1902,3,198,0,83,842,118,530,83
Modoc,2/12/2021,4,1906,0,4,0,2,842,2,532,2
Modoc,2/13/2021,1,1907,0,1,0,1,843,0,532,1
Modoc,2/16/2021,147,2054,6,141,0,143,982,4,536,143
Modoc,2/17/2021,24,2078,1,23,0,12,982,12,548,12
Modoc,2/18/2021,188,2266,2,186,0,25,846,162,710,26
Modoc,2/19/2021,2,2268,2,0,0,2,848,0,710,2
Modoc,2/20/2021,1,2269,1,0,0,1,849,0,710,1
Modoc,2/22/2021,17,2286,9,8,0,3,838,14,724,3
Modoc,2/23/2021,20,2306,2,18,0,1,820,19,743,1
Modoc,2/24/2021,90,2396,1,89,0,30,790,60,803,30
Modoc,2/25/2021,169,2565,1,168,0,13,647,156,959,13
Modoc,2/26/2021,3,2568,0,3,0,1,646,2,961,1
Modoc,2/27/2021,5,2573,5,0,0,2,645,3,964,2
Modoc,3/1/2021,4,2577,0,4,0,0,641,4,968,0
Modoc,3/2/2021,193,2770,12,181,0,26,500,167,1135,26
Modoc,3/3/2021,12,2782,6,6,0,2,492,10,1145,2
Modoc,3/4/2021,175,2957,2,173,0,148,613,27,1172,148
Modoc,3/5/2021,4,2961,3,1,0,2,613,2,1174,2
Modoc,3/6/2021,10,2971,0,0,10,0,613,10,1184,10
Modoc,3/7/2021,6,2977,1,0,5,1,614,5,1189,6
Modoc,3/8/2021,7,2984,1,2,4,1,613,6,1195,5
Modoc,3/9/2021,126,3110,10,108,8,61,617,65,1260,69
Modoc,3/10/2021,9,3119,3,2,4,4,620,5,1265,8
Modoc,3/11/2021,207,3326,0,99,108,22,565,185,1450,130
Modoc,3/12/2021,10,3336,1,4,5,4,568,6,1456,9
Modoc,3/13/2021,4,3340,0,1,3,1,569,3,1459,4
Modoc,3/15/2021,12,3352,1,10,1,10,578,2,1461,11
Modoc,3/16/2021,173,3525,1,168,4,42,492,131,1592,45
Modoc,3/17/2021,10,3535,1,4,5,2,491,8,1600,7
Modoc,3/18/2021,66,3601,1,58,7,34,500,32,1632,41
Modoc,3/19/2021,5,3606,0,0,5,0,500,5,1637,5
Modoc,3/20/2021,6,3612,2,1,3,1,499,5,1642,4
Modoc,3/21/2021,4,3616,1,1,2,2,501,2,1644,4
Modoc,3/22/2021,18,3634,1,11,6,12,513,6,1650,18
Modoc,3/23/2021,35,3669,5,27,3,27,535,8,1658,30
Modoc,3/24/2021,29,3698,1,18,10,2,520,27,1685,12
Modoc,3/25/2021,76,3774,1,73,2,44,534,32,1717,46
Modoc,3/26/2021,7,3781,2,2,3,2,534,5,1722,5
Modoc,3/27/2021,2,3783,0,1,1,1,535,1,1723,2
Modoc,3/28/2021,2,3785,1,0,1,0,534,2,1725,1
Modoc,3/29/2021,14,3799,1,5,8,5,538,9,1734,13
Modoc,3/30/2021,56,3855,10,39,7,22,533,34,1768,29
Modoc,3/31/2021,9,3864,3,2,4,3,534,6,1774,7
Modoc,4/1/2021,170,4034,3,162,5,35,439,135,1909,40
Modoc,4/2/2021,4,4038,0,1,3,0,439,3,1912,3
Modoc,4/3/2021,4,4042,2,0,2,2,441,2,1914,4
Modoc,4/5/2021,9,4051,0,9,0,9,450,0,1914,9
Modoc,4/6/2021,24,4075,5,9,10,6,448,18,1932,16
Modoc,4/7/2021,11,4086,1,4,6,3,449,8,1940,9
Modoc,4/8/2021,97,4183,1,93,3,26,407,71,2011,29
Modoc,4/9/2021,11,4194,2,6,3,2,402,9,2020,4
Modoc,4/10/2021,5,4199,0,1,4,0,401,5,2025,4
Modoc,4/11/2021,2,4201,2,0,0,1,401,1,2026,1
Modoc,4/12/2021,14,4215,1,9,4,1,395,11,2037,5
Modoc,4/13/2021,28,4243,27,1,0,21,409,7,2044,21
Modoc,4/14/2021,2,4245,2,0,0,1,409,1,2045,1
Modoc,4/15/2021,99,4344,0,99,0,26,362,73,2118,26
Modoc,4/16/2021,4,4348,4,0,0,3,364,1,2119,3
Modoc,4/17/2021,2,4350,2,0,0,2,366,0,2119,2
Modoc,4/18/2021,1,4351,0,1,0,1,367,0,2119,1
Modoc,4/19/2021,7,4358,1,6,0,2,364,5,2124,2
Modoc,4/20/2021,27,4385,2,25,0,9,355,18,2142,9
Modoc,4/21/2021,1,4386,1,0,0,0,354,1,2143,0
Modoc,4/22/2021,90,4476,2,88,0,33,331,57,2200,34
Modoc,4/23/2021,3,4479,0,3,0,2,332,1,2201,2
Mono,12/18/2020,1,1,1,0,0,1,1,0,0,1
Mono,12/19/2020,5,6,5,0,0,5,6,0,0,5
Mono,12/20/2020,7,13,7,0,0,7,13,0,0,7
Mono,12/21/2020,24,37,17,7,0,24,37,0,0,24
Mono,12/22/2020,66,103,65,1,0,66,103,0,0,66
Mono,12/23/2020,70,173,42,28,0,70,173,0,0,70
Mono,12/24/2020,3,176,1,2,0,3,176,0,0,3
Mono,12/26/2020,3,179,3,0,0,3,179,0,0,3
Mono,12/28/2020,94,273,63,31,0,94,273,0,0,94
Mono,12/29/2020,29,302,29,0,0,29,302,0,0,29
Mono,12/30/2020,76,378,35,41,0,76,378,0,0,76
Mono,12/31/2020,4,382,1,3,0,4,382,0,0,4
Mono,1/1/2021,4,386,4,0,0,4,386,0,0,4
Mono,1/2/2021,2,388,2,0,0,2,388,0,0,2
Mono,1/4/2021,1,389,0,1,0,1,389,0,0,1
Mono,1/5/2021,45,434,2,43,0,44,432,1,1,44
Mono,1/6/2021,44,478,0,44,0,44,476,0,1,44
Mono,1/7/2021,55,533,3,52,0,54,529,1,2,54
Mono,1/8/2021,2,535,1,1,0,1,529,1,3,1
Mono,1/9/2021,4,539,4,0,0,0,525,4,7,0
Mono,1/10/2021,5,544,5,0,0,0,520,5,12,0
Mono,1/11/2021,8,552,5,3,0,4,520,4,16,4
Mono,1/12/2021,282,834,75,207,0,218,675,63,79,218
Mono,1/13/2021,233,1067,73,160,0,178,798,55,134,178
Mono,1/14/2021,73,1140,71,2,0,73,871,0,134,73
Mono,1/15/2021,62,1202,2,60,0,62,933,0,134,62
Mono,1/16/2021,4,1206,3,1,0,1,931,3,137,1
Mono,1/18/2021,63,1269,54,9,0,2,872,61,198,2
Mono,1/19/2021,209,1478,207,2,0,171,1006,38,236,172
Mono,1/20/2021,230,1708,199,31,0,169,1114,61,297,169
Mono,1/21/2021,3,1711,3,0,0,3,1117,0,297,3
Mono,1/22/2021,4,1715,0,4,0,4,1121,0,297,4
Mono,1/23/2021,595,2310,595,0,0,594,1714,1,298,594
Mono,1/25/2021,205,2515,167,38,0,166,1841,39,337,166
Mono,1/26/2021,507,3022,505,2,0,501,2336,6,343,501
Mono,1/27/2021,5,3027,1,4,0,5,2341,0,343,5
Mono,1/28/2021,7,3034,3,4,0,3,2340,4,347,3
Mono,1/30/2021,202,3236,200,2,0,201,2540,1,348,201
Mono,1/31/2021,243,3479,138,105,0,139,2575,104,452,139
Mono,2/1/2021,27,3506,27,0,0,0,2548,27,479,0
Mono,2/2/2021,5,3511,0,5,0,2,2547,3,482,2
Mono,2/3/2021,4,3515,2,2,0,2,2547,2,484,2
Mono,2/4/2021,211,3726,158,53,0,90,2516,121,605,90
Mono,2/5/2021,619,4345,613,6,0,616,3129,3,608,616
Mono,2/6/2021,139,4484,138,1,0,137,3264,2,610,137
Mono,2/7/2021,2,4486,0,2,0,2,3266,0,610,2
Mono,2/8/2021,171,4657,171,0,0,15,3126,155,765,15
Mono,2/9/2021,226,4883,6,220,0,14,2928,212,977,14
Mono,2/10/2021,536,5419,186,350,0,194,2781,342,1319,195
Mono,2/11/2021,7,5426,4,3,0,2,2778,5,1324,2
Mono,2/12/2021,84,5510,20,64,0,26,2746,58,1382,26
Mono,2/13/2021,586,6096,586,0,0,25,2211,560,1942,25
Mono,2/15/2021,168,6264,166,2,0,3,2051,163,2105,3
Mono,2/16/2021,518,6782,515,3,0,45,1626,470,2575,45
Mono,2/17/2021,5,6787,1,4,0,1,1623,4,2579,1
Mono,2/18/2021,3,6790,2,1,0,2,1624,1,2580,2
Mono,2/19/2021,54,6844,53,1,0,54,1678,0,2580,54
Mono,2/20/2021,4,6848,4,0,0,4,1682,0,2580,4
Mono,2/21/2021,3,6851,3,0,0,3,1685,0,2580,3
Mono,2/22/2021,285,7136,284,1,0,24,1449,260,2840,24
Mono,2/23/2021,135,7271,115,20,0,22,1358,113,2953,22
Mono,2/24/2021,8,7279,3,5,0,2,1354,6,2959,2
Mono,2/25/2021,5,7284,2,3,0,3,1356,1,2960,3
Mono,2/26/2021,600,7884,599,1,0,20,797,579,3539,20
Mono,2/27/2021,141,8025,137,4,0,4,667,134,3673,4
Mono,3/1/2021,2,8027,2,0,0,1,668,0,3673,1
Mono,3/2/2021,5,8032,3,2,0,3,669,2,3675,3
Mono,3/3/2021,82,8114,2,80,0,79,746,2,3677,79
Mono,3/4/2021,4,8118,0,4,0,2,746,2,3679,2
Mono,3/5/2021,37,8155,27,10,0,14,737,23,3702,14
Mono,3/6/2021,509,8664,16,493,0,503,1235,5,3707,503
Mono,3/7/2021,1,8665,0,1,0,0,1234,1,3708,0
Mono,3/8/2021,540,9205,11,526,3,531,1759,9,3717,534
Mono,3/9/2021,6,9211,2,3,1,3,1761,2,3719,4
Mono,3/10/2021,286,9497,91,192,3,10,1500,274,3993,13
Mono,3/11/2021,11,9508,0,1,10,0,1499,11,4004,10
Mono,3/12/2021,7,9515,1,1,5,0,1497,7,4011,5
Mono,3/13/2021,826,10341,389,437,0,818,2307,8,4019,818
Mono,3/14/2021,4,10345,4,0,0,1,2305,3,4022,1
Mono,3/15/2021,29,10374,23,1,5,12,2306,16,4038,17
Mono,3/16/2021,16,10390,6,4,6,8,2312,8,4046,14
Mono,3/17/2021,32,10422,3,21,8,21,2330,11,4057,29
Mono,3/18/2021,21,10443,2,11,8,9,2335,12,4069,17
Mono,3/19/2021,21,10464,1,17,3,17,2352,3,4072,20
Mono,3/20/2021,5,10469,3,1,1,4,2356,1,4073,5
Mono,3/21/2021,1,10470,1,0,0,1,2357,0,4073,1
Mono,3/22/2021,11,10481,0,6,5,5,2361,6,4079,10
Mono,3/23/2021,42,10523,5,32,5,19,2362,23,4102,24
Mono,3/24/2021,12,10535,1,6,5,6,2367,6,4108,11
Mono,3/25/2021,18,10553,2,12,4,12,2377,6,4114,16
Mono,3/26/2021,19,10572,3,11,5,10,2384,8,4122,15
Mono,3/27/2021,354,10926,351,3,0,328,2686,26,4148,328
Mono,3/28/2021,1,10927,1,0,0,1,2687,0,4148,1
Mono,3/29/2021,10,10937,3,6,1,8,2694,2,4150,9
Mono,3/30/2021,15,10952,0,11,4,10,2703,5,4155,14
Mono,3/31/2021,125,11077,7,117,1,46,2672,78,4233,47
Mono,4/1/2021,8,11085,0,7,1,3,2671,5,4238,4
Mono,4/2/2021,17,11102,2,15,0,6,2666,11,4249,6
Mono,4/3/2021,849,11951,366,483,0,35,1888,813,5062,35
Mono,4/5/2021,529,12480,17,511,1,31,1423,497,5559,32
Mono,4/6/2021,20,12500,2,5,13,2,1420,18,5577,15
Mono,4/7/2021,23,12523,2,2,19,3,1422,20,5597,22
Mono,4/8/2021,21,12544,2,2,17,3,1424,18,5615,20
Mono,4/9/2021,37,12581,4,4,29,7,1430,30,5645,36
Mono,4/10/2021,446,13027,2,437,7,28,1047,418,6063,35
Mono,4/11/2021,1,13028,1,0,0,0,1046,1,6064,0
Mono,4/12/2021,6,13034,0,3,3,3,1049,3,6067,6
Mono,4/13/2021,18,13052,2,15,1,12,1056,6,6073,13
Mono,4/14/2021,26,13078,1,25,0,7,1044,19,6092,7
Mono,4/15/2021,18,13096,3,15,0,9,1044,9,6101,9
Mono,4/16/2021,14,13110,1,13,0,5,1040,9,6110,5
Mono,4/17/2021,51,13161,2,49,0,44,1077,7,6117,44
Mono,4/18/2021,2,13163,1,1,0,2,1079,0,6117,2
Mono,4/19/2021,527,13690,320,207,0,200,954,325,6442,200
Mono,4/20/2021,16,13706,2,14,0,11,960,5,6447,11
Mono,4/21/2021,10,13716,1,9,0,3,956,7,6454,3
Mono,4/22/2021,30,13746,15,15,0,12,950,18,6472,12
Mono,4/23/2021,4,13750,2,2,0,1,948,3,6475,1
Monterey,12/16/2020,4,4,4,0,0,4,4,0,0,4
Monterey,12/17/2020,83,87,83,0,0,83,87,0,0,83
Monterey,12/18/2020,481,568,481,0,0,481,568,0,0,481
Monterey,12/19/2020,579,1147,579,0,0,579,1147,0,0,579
Monterey,12/20/2020,422,1569,422,0,0,422,1569,0,0,422
Monterey,12/21/2020,719,2288,719,0,0,719,2288,0,0,719
Monterey,12/22/2020,533,2821,520,13,0,533,2821,0,0,533
Monterey,12/23/2020,436,3257,261,175,0,436,3257,0,0,436
Monterey,12/24/2020,84,3341,10,74,0,84,3341,0,0,84
Monterey,12/25/2020,6,3347,0,6,0,6,3347,0,0,6
Monterey,12/26/2020,92,3439,5,87,0,92,3439,0,0,92
Monterey,12/27/2020,7,3446,4,3,0,7,3446,0,0,7
Monterey,12/28/2020,475,3921,25,450,0,475,3921,0,0,475
Monterey,12/29/2020,900,4821,167,733,0,900,4821,0,0,900
Monterey,12/30/2020,568,5389,98,470,0,568,5389,0,0,568
Monterey,12/31/2020,34,5423,11,23,0,34,5423,0,0,34
Monterey,1/1/2021,12,5435,2,10,0,12,5435,0,0,12
Monterey,1/2/2021,137,5572,134,3,0,137,5572,0,0,137
Monterey,1/3/2021,30,5602,29,1,0,30,5602,0,0,30
Monterey,1/4/2021,410,6012,18,392,0,410,6012,0,0,410
Monterey,1/5/2021,750,6762,326,424,0,736,6734,14,14,736
Monterey,1/6/2021,655,7417,172,483,0,633,7345,22,36,633
Monterey,1/7/2021,746,8163,572,174,0,422,7445,322,358,422
Monterey,1/8/2021,1085,9248,733,352,0,393,7146,692,1050,393
Monterey,1/9/2021,962,10210,934,28,0,312,6808,650,1700,312
Monterey,1/10/2021,273,10483,270,3,0,8,6551,265,1965,8
Monterey,1/11/2021,1065,11548,984,81,0,362,6210,703,2668,362
Monterey,1/12/2021,464,12012,387,77,0,203,6152,261,2929,203
Monterey,1/13/2021,1217,13229,591,626,0,1172,7279,45,2974,1172
Monterey,1/14/2021,1047,14276,93,954,0,1029,8293,18,2992,1032
Monterey,1/15/2021,1045,15321,44,1001,0,1032,9312,13,3005,1032
Monterey,1/16/2021,361,15682,298,63,0,356,9663,5,3010,356
Monterey,1/17/2021,309,15991,288,21,0,296,9946,13,3023,296
Monterey,1/18/2021,402,16393,50,352,0,381,10306,21,3044,381
Monterey,1/19/2021,576,16969,395,181,0,417,10566,157,3201,417
Monterey,1/20/2021,530,17499,268,262,0,324,10684,206,3407,324
Monterey,1/21/2021,840,18339,93,747,0,730,11308,110,3517,734
Monterey,1/22/2021,1048,19387,191,857,0,1009,12278,39,3556,1009
Monterey,1/23/2021,240,19627,174,66,0,117,12274,122,3678,118
Monterey,1/24/2021,56,19683,38,18,0,22,12262,34,3712,22
Monterey,1/25/2021,782,20465,173,609,0,156,11799,619,4331,156
Monterey,1/26/2021,927,21392,223,704,0,235,11342,692,5023,235
Monterey,1/27/2021,857,22249,307,550,0,377,11239,480,5503,377
Monterey,1/28/2021,2008,24257,736,1272,0,1667,12567,341,5844,1669
Monterey,1/29/2021,1225,25482,705,520,0,1109,13562,115,5959,1110
Monterey,1/30/2021,437,25919,290,147,0,182,13489,255,6214,182
Monterey,1/31/2021,493,26412,71,422,0,483,13963,10,6224,484
Monterey,2/1/2021,1660,28072,1146,514,0,1098,14500,561,6785,1098
Monterey,2/2/2021,2151,30223,454,1697,0,1544,15438,606,7391,1544
Monterey,2/3/2021,2327,32550,1046,1281,0,1552,16219,771,8162,1552
Monterey,2/4/2021,2703,35253,2019,684,0,2441,18400,260,8422,2441
Monterey,2/5/2021,3640,38893,2820,820,0,3208,21181,427,8849,3208
Monterey,2/6/2021,1095,39988,378,717,0,754,21596,339,9188,754
Monterey,2/7/2021,314,40302,270,44,0,95,21472,219,9407,95
Monterey,2/8/2021,515,40817,289,226,0,429,21815,86,9493,429
Monterey,2/9/2021,860,41677,673,187,0,550,22057,310,9803,552
Monterey,2/10/2021,2010,43687,1040,970,0,1162,22371,848,10651,1162
Monterey,2/11/2021,2495,46182,968,1527,0,1541,22962,952,11603,1543
Monterey,2/12/2021,2584,48766,426,2158,0,1522,23423,1061,12664,1522
Monterey,2/13/2021,1068,49834,50,1018,0,977,24309,91,12755,977
Monterey,2/14/2021,589,50423,73,516,0,516,24752,73,12828,516
Monterey,2/15/2021,1368,51791,160,1208,0,993,25373,373,13201,994
Monterey,2/16/2021,1088,52879,243,845,0,866,26017,222,13423,866
Monterey,2/17/2021,1934,54813,1161,773,0,1635,27358,297,13720,1638
Monterey,2/18/2021,2222,57035,1176,1046,0,907,26962,1305,15025,909
Monterey,2/19/2021,2934,59969,1530,1404,0,1344,26716,1590,16615,1344
Monterey,2/20/2021,1003,60972,603,400,0,951,27616,51,16666,951
Monterey,2/21/2021,1239,62211,1211,28,0,1170,28719,67,16733,1170
Monterey,2/22/2021,975,63186,844,131,0,642,29030,331,17064,642
Monterey,2/23/2021,949,64135,617,332,0,299,28681,649,17713,300
Monterey,2/24/2021,2458,66593,1312,1146,0,1847,29922,607,18320,1848
Monterey,2/25/2021,4342,70935,2377,1965,0,1449,28486,2886,21206,1450
Monterey,2/26/2021,5241,76176,3079,2162,0,2620,28489,2618,23824,2621
Monterey,2/27/2021,995,77171,182,813,0,805,29109,185,24009,805
Monterey,2/28/2021,1527,78698,81,1446,0,1065,29717,457,24466,1065
Monterey,3/1/2021,1277,79975,137,1137,3,742,29931,532,24998,746
Monterey,3/2/2021,2727,82702,1717,1010,0,1878,30964,845,25843,1878
Monterey,3/3/2021,3194,85896,1236,1958,0,1303,30379,1889,27732,1304
Monterey,3/4/2021,4544,90440,1464,3080,0,2975,31789,1565,29297,2975
Monterey,3/5/2021,3253,93693,1418,1558,277,2623,34060,629,29926,2900
Monterey,3/6/2021,4992,98685,1065,3625,302,4089,37549,900,30826,4389
Monterey,3/7/2021,521,99206,108,168,245,234,37739,287,31113,477
Monterey,3/8/2021,1645,100851,325,941,379,1116,38704,529,31642,1494
Monterey,3/9/2021,1901,102752,675,950,276,1414,39906,486,32128,1688
Monterey,3/10/2021,2908,105660,870,1553,485,1356,40202,1546,33674,1842
Monterey,3/11/2021,4098,109758,1402,2324,372,2337,41157,1754,35428,2709
Monterey,3/12/2021,4260,114018,2015,2128,117,2599,42213,1659,37087,2715
Monterey,3/13/2021,5227,119245,961,3919,347,3921,45175,1306,38393,4268
Monterey,3/14/2021,2147,121392,1326,796,25,576,44216,1560,39953,601
Monterey,3/15/2021,3941,125333,1265,2386,290,2254,45076,1683,41636,2543
Monterey,3/16/2021,3486,128819,570,2542,374,2075,46113,1410,43046,2447
Monterey,3/17/2021,5674,134493,2307,3116,251,4084,48871,1582,44628,4340
Monterey,3/18/2021,4351,138844,2153,2031,167,3004,50740,1342,45970,3211
Monterey,3/19/2021,5383,144227,2558,2683,142,4114,53733,1264,47234,4257
Monterey,3/20/2021,3246,147473,420,2131,695,2167,55520,1075,48309,2862
Monterey,3/21/2021,622,148095,200,414,8,556,56018,65,48374,563
Monterey,3/22/2021,2451,150546,1430,960,61,2246,58122,202,48576,2306
Monterey,3/23/2021,3961,154507,2345,1574,42,2507,59222,1449,50025,2549
Monterey,3/24/2021,4973,159480,2084,2578,311,3621,61804,1348,51373,3930
Monterey,3/25/2021,5206,164686,1213,3636,357,2609,62182,2589,53962,2967
Monterey,3/26/2021,5290,169976,2604,2620,66,2847,62663,2434,56396,2915
Monterey,3/27/2021,4747,174723,1415,3076,256,3038,64252,1705,58101,3294
Monterey,3/28/2021,1109,175832,334,767,8,628,64411,477,58578,636
Monterey,3/29/2021,3164,178996,1402,1748,14,1950,65171,1207,59785,1967
Monterey,3/30/2021,4434,183430,2130,2264,40,2749,66291,1674,61459,2794
Monterey,3/31/2021,5278,188708,2375,2112,791,3321,68452,1953,63412,4114
Monterey,4/1/2021,6011,194719,2057,3549,405,3012,68883,2986,66398,3417
Monterey,4/2/2021,4659,199378,2241,2357,61,3285,70860,1372,67770,3349
Monterey,4/3/2021,5611,204989,1091,3556,964,1189,68602,4407,72177,2149
Monterey,4/4/2021,751,205740,155,583,13,483,68832,268,72445,498
Monterey,4/5/2021,3961,209701,2458,1276,227,1484,68071,2472,74917,1711
Monterey,4/6/2021,3092,212793,1306,1315,471,1120,67695,1967,76884,1591
Monterey,4/7/2021,5467,218260,1401,3557,509,2697,68141,2759,79643,3205
Monterey,4/8/2021,6353,224613,3453,2100,800,3165,68925,3182,82825,3966
Monterey,4/9/2021,5511,230124,3368,1514,629,2233,68511,3274,86099,2860
Monterey,4/10/2021,9793,239917,4925,2720,2148,4922,70718,4863,90962,7070
Monterey,4/11/2021,5432,245349,4267,567,598,4394,74677,1032,91994,4991
Monterey,4/12/2021,4019,249368,1843,1866,310,894,72894,2987,94981,1204
Monterey,4/13/2021,3109,252477,712,2393,4,1488,72787,1600,96581,1493
Monterey,4/14/2021,6531,259008,3110,3419,2,1785,69841,4733,101314,1787
Monterey,4/15/2021,5708,264716,3860,1848,0,3808,71779,1870,103184,3808
Monterey,4/16/2021,4644,269360,2376,2254,14,2170,71500,2463,105647,2184
Monterey,4/17/2021,4290,273650,1327,2963,0,3132,73482,1150,106797,3132
Monterey,4/18/2021,831,274481,253,578,0,235,73125,592,107389,235
Monterey,4/19/2021,3663,278144,1278,2385,0,1756,72982,1899,109288,1756
Monterey,4/20/2021,3697,281841,1558,2139,0,1534,72375,2142,111430,1535
Monterey,4/21/2021,5501,287342,3094,2407,0,2701,72311,2767,114197,2703
Monterey,4/22/2021,4365,291707,921,3444,0,1735,71439,2607,116804,1735
Monterey,4/23/2021,3916,295623,1989,1926,1,1486,70506,2420,119224,1487
Napa,12/16/2020,12,12,12,0,0,12,12,0,0,12
Napa,12/17/2020,44,56,44,0,0,44,56,0,0,44
Napa,12/18/2020,102,158,102,0,0,102,158,0,0,102
Napa,12/19/2020,221,379,221,0,0,221,379,0,0,221
Napa,12/20/2020,188,567,188,0,0,188,567,0,0,188
Napa,12/21/2020,310,877,310,0,0,311,878,0,0,311
Napa,12/22/2020,340,1217,331,9,0,340,1218,0,0,340
Napa,12/23/2020,428,1645,319,109,0,428,1646,0,0,428
Napa,12/24/2020,139,1784,78,61,0,139,1785,0,0,139
Napa,12/25/2020,1,1785,1,0,0,1,1786,0,0,1
Napa,12/26/2020,39,1824,11,28,0,39,1825,0,0,39
Napa,12/27/2020,32,1856,16,16,0,32,1857,0,0,32
Napa,12/28/2020,251,2107,185,66,0,279,2136,0,0,279
Napa,12/29/2020,273,2380,214,59,0,307,2443,0,0,307
Napa,12/30/2020,630,3010,486,144,0,638,3081,0,0,638
Napa,12/31/2020,461,3471,373,88,0,461,3542,0,0,461
Napa,1/1/2021,1,3472,1,0,0,1,3543,0,0,1
Napa,1/2/2021,98,3570,93,5,0,98,3641,0,0,98
Napa,1/3/2021,13,3583,11,2,0,9,3650,0,0,9
Napa,1/4/2021,107,3690,64,43,0,107,3757,0,0,107
Napa,1/5/2021,155,3845,85,70,0,138,3871,24,24,138
Napa,1/6/2021,455,4300,114,341,0,391,4200,62,86,391
Napa,1/7/2021,495,4795,234,261,0,395,4496,99,185,395
Napa,1/8/2021,442,5237,226,216,0,262,4579,179,364,262
Napa,1/9/2021,325,5562,300,25,0,189,4632,136,500,189
Napa,1/10/2021,184,5746,101,83,0,109,4666,75,575,109
Napa,1/11/2021,881,6627,426,455,0,508,4801,374,949,509
Napa,1/12/2021,1311,7938,370,941,0,996,5482,315,1264,996
Napa,1/13/2021,1313,9251,264,1049,0,1151,6473,161,1425,1152
Napa,1/14/2021,1052,10303,173,879,0,934,7291,116,1541,934
Napa,1/15/2021,1453,11756,384,1069,0,1305,8441,156,1697,1306
Napa,1/16/2021,356,12112,134,222,0,338,8761,18,1715,338
Napa,1/17/2021,340,12452,175,165,0,330,9081,10,1725,330
Napa,1/18/2021,1081,13533,197,884,0,990,9980,91,1816,990
Napa,1/19/2021,1009,14542,406,603,0,766,10504,242,2058,766
Napa,1/20/2021,825,15367,185,640,0,643,10967,180,2238,643
Napa,1/21/2021,1335,16702,374,961,0,1080,11794,254,2492,1081
Napa,1/22/2021,1539,18241,411,1128,0,1212,12681,326,2818,1213
Napa,1/23/2021,398,18639,318,80,0,336,12955,62,2880,336
Napa,1/24/2021,266,18905,189,77,0,208,13105,58,2938,208
Napa,1/25/2021,1522,20427,231,1291,0,1432,14447,90,3028,1432
Napa,1/26/2021,880,21307,283,597,0,786,15140,94,3122,787
Napa,1/27/2021,626,21933,220,406,0,470,15455,156,3278,471
Napa,1/28/2021,390,22323,177,213,0,198,15463,190,3468,198
Napa,1/29/2021,254,22577,65,189,0,159,15527,95,3563,159
Napa,1/30/2021,804,23381,695,109,0,640,16003,164,3727,640
Napa,1/31/2021,655,24036,625,30,0,629,16606,26,3753,629
Napa,2/1/2021,315,24351,110,205,0,163,16617,152,3905,163
Napa,2/2/2021,594,24945,281,313,0,292,16610,299,4204,292
Napa,2/3/2021,741,25686,309,432,0,432,16733,309,4513,432
Napa,2/4/2021,789,26475,374,415,0,441,16828,346,4859,441
Napa,2/5/2021,707,27182,314,393,0,340,16801,367,5226,340
Napa,2/6/2021,434,27616,145,289,0,329,17025,105,5331,329
Napa,2/7/2021,175,27791,162,13,0,71,16992,104,5435,71
Napa,2/8/2021,834,28625,191,643,0,272,16705,559,5994,272
Napa,2/9/2021,1075,29700,441,634,0,436,16502,639,6633,436
Napa,2/10/2021,1720,31420,192,1528,0,452,15690,1265,7898,453
Napa,2/11/2021,1491,32911,194,1297,0,406,15024,1073,8971,407
Napa,2/12/2021,2156,35067,837,1319,0,721,14313,1432,10403,721
Napa,2/13/2021,495,35562,52,443,0,312,14442,183,10586,312
Napa,2/14/2021,356,35918,90,266,0,195,14476,161,10747,195
Napa,2/15/2021,872,36790,182,690,0,220,14046,650,11397,220
Napa,2/16/2021,1286,38076,597,689,0,612,13985,673,12070,612
Napa,2/17/2021,1046,39122,530,516,0,479,13899,565,12635,479
Napa,2/18/2021,1894,41016,484,1410,0,658,13324,1233,13868,658
Napa,2/19/2021,1479,42495,584,895,0,676,13198,802,14670,676
Napa,2/20/2021,820,43315,595,225,0,272,12922,548,15218,272
Napa,2/21/2021,797,44112,735,62,0,195,12515,602,15820,195
Napa,2/22/2021,441,44553,185,256,0,136,12346,305,16125,136
Napa,2/23/2021,1125,45678,301,824,0,307,11835,818,16943,307
Napa,2/24/2021,1158,46836,638,520,0,570,11820,586,17529,571
Napa,2/25/2021,2538,49374,1210,1328,0,1825,12933,712,18241,1825
Napa,2/26/2021,1496,50870,521,975,0,583,12605,911,19152,583
Napa,2/27/2021,1118,51988,378,740,0,866,13221,250,19402,866
Napa,2/28/2021,560,52548,459,101,0,461,13585,97,19499,461
Napa,3/1/2021,1101,53649,814,287,0,832,14149,268,19767,832
Napa,3/2/2021,1484,55133,1024,460,0,1150,14966,333,20100,1150
Napa,3/3/2021,1544,56677,684,860,0,1358,16139,185,20285,1358
Napa,3/4/2021,1705,58382,782,923,0,1467,17371,235,20520,1467
Napa,3/5/2021,1890,60272,782,1104,4,1475,18437,413,20933,1479
Napa,3/6/2021,641,60913,281,329,31,530,18889,109,21042,561
Napa,3/7/2021,521,61434,320,186,15,370,19123,151,21193,385
Napa,3/8/2021,694,62128,319,322,53,517,19518,175,21368,570
Napa,3/9/2021,1628,63756,567,1015,46,1198,20335,427,21795,1244
Napa,3/10/2021,1472,65228,914,466,92,772,20502,697,22492,864
Napa,3/11/2021,1829,67057,1035,666,128,937,20676,891,23383,1065
Napa,3/12/2021,1495,68552,908,492,95,794,20865,699,24082,888
Napa,3/13/2021,1164,69716,300,840,24,828,21383,334,24416,852
Napa,3/14/2021,611,70327,328,135,148,227,21374,383,24799,374
Napa,3/15/2021,945,71272,405,471,69,479,21458,464,25263,548
Napa,3/16/2021,1832,73104,385,1321,126,1372,22501,456,25719,1499
Napa,3/17/2021,2481,75585,1845,457,179,1577,23353,904,26623,1756
Napa,3/18/2021,2098,77683,912,1176,10,1288,23843,808,27431,1298
Napa,3/19/2021,1429,79112,857,544,28,710,23865,716,28147,738
Napa,3/20/2021,995,80107,527,315,153,422,23868,572,28719,575
Napa,3/21/2021,702,80809,680,20,2,352,23873,349,29068,354
Napa,3/22/2021,1079,81888,904,164,11,474,23756,602,29670,485
Napa,3/23/2021,1506,83394,815,674,17,1000,24269,504,30174,1017
Napa,3/24/2021,1701,85095,942,751,8,820,24217,880,31054,828
Napa,3/25/2021,1611,86706,1041,516,54,742,24145,868,31922,796
Napa,3/26/2021,1276,87982,826,444,6,576,24030,697,32619,582
Napa,3/27/2021,946,88928,431,488,27,313,23737,633,33252,340
Napa,3/28/2021,482,89410,372,103,7,182,23627,299,33551,189
Napa,3/29/2021,1177,90587,857,315,5,726,23908,450,34001,731
Napa,3/30/2021,2393,92980,929,1460,4,1611,24741,782,34783,1615
Napa,3/31/2021,1956,94936,954,933,69,805,24465,1148,35931,872
Napa,4/1/2021,1704,96640,810,779,115,472,23825,1227,37158,587
Napa,4/2/2021,1821,98461,814,865,142,456,23061,1362,38520,598
Napa,4/3/2021,624,99085,362,203,59,209,22913,415,38935,267
Napa,4/4/2021,351,99436,142,151,58,122,22865,228,39163,180
Napa,4/5/2021,1262,100698,753,291,218,573,22968,688,39851,791
Napa,4/6/2021,2209,102907,557,1397,255,529,22075,1677,41528,784
Napa,4/7/2021,1704,104611,684,799,221,519,21634,1181,42709,740
Napa,4/8/2021,1829,106440,1055,404,370,974,22126,851,43560,1343
Napa,4/9/2021,1505,107945,908,297,300,672,22266,831,44391,971
Napa,4/10/2021,1027,108972,346,581,100,237,21814,789,45180,337
Napa,4/11/2021,384,109356,301,62,21,157,21765,227,45407,178
Napa,4/12/2021,786,110142,303,360,123,296,21693,489,45896,417
Napa,4/13/2021,2514,112656,839,1675,0,917,21017,1593,47489,917
Napa,4/14/2021,2037,114693,974,1063,0,1009,21005,1021,48510,1009
Napa,4/15/2021,1589,116282,518,1071,0,861,21143,723,49233,861
Napa,4/16/2021,2417,118699,1127,1290,0,1741,22209,675,49908,1741
Napa,4/17/2021,1073,119772,263,810,0,816,22768,257,50165,816
Napa,4/18/2021,262,120034,171,91,0,118,22743,143,50308,118
Napa,4/19/2021,605,120639,336,269,0,264,22667,340,50648,264
Napa,4/20/2021,2906,123545,1940,966,0,1964,23691,941,51589,1965
Napa,4/21/2021,2275,125820,1668,606,1,1245,23911,1025,52614,1245
Napa,4/22/2021,961,126781,715,246,0,273,23499,685,53299,273
Napa,4/23/2021,497,127278,406,89,2,391,23786,104,53403,391
Nevada,12/16/2020,3,3,3,0,0,3,3,0,0,3
Nevada,12/17/2020,6,9,6,0,0,6,9,0,0,6
Nevada,12/18/2020,52,61,52,0,0,52,61,0,0,52
Nevada,12/19/2020,55,116,55,0,0,55,116,0,0,55
Nevada,12/20/2020,12,128,12,0,0,12,128,0,0,12
Nevada,12/21/2020,69,197,69,0,0,69,197,0,0,69
Nevada,12/22/2020,91,288,89,2,0,91,288,0,0,91
Nevada,12/23/2020,234,522,202,32,0,234,522,0,0,234
Nevada,12/24/2020,13,535,11,2,0,13,535,0,0,13
Nevada,12/25/2020,3,538,3,0,0,3,538,0,0,3
Nevada,12/26/2020,6,544,4,2,0,6,544,0,0,6
Nevada,12/27/2020,88,632,88,0,0,88,632,0,0,88
Nevada,12/28/2020,170,802,93,77,0,170,802,0,0,170
Nevada,12/29/2020,100,902,74,26,0,100,902,0,0,100
Nevada,12/30/2020,86,988,66,20,0,86,988,0,0,86
Nevada,12/31/2020,39,1027,9,30,0,39,1027,0,0,39
Nevada,1/1/2021,1,1028,0,1,0,1,1028,0,0,1
Nevada,1/2/2021,1,1029,1,0,0,1,1029,0,0,1
Nevada,1/3/2021,129,1158,126,3,0,129,1158,0,0,129
Nevada,1/4/2021,71,1229,47,24,0,71,1229,0,0,71
Nevada,1/5/2021,271,1500,130,141,0,270,1498,1,1,270
Nevada,1/6/2021,91,1591,43,48,0,83,1573,8,9,83
Nevada,1/7/2021,215,1806,43,172,0,208,1776,6,15,209
Nevada,1/8/2021,221,2027,127,94,0,169,1893,52,67,169
Nevada,1/9/2021,63,2090,56,7,0,15,1860,48,115,15
Nevada,1/10/2021,17,2107,9,8,0,9,1861,8,123,9
Nevada,1/11/2021,185,2292,131,54,0,57,1790,128,251,57
Nevada,1/12/2021,597,2889,451,146,0,531,2255,66,317,531
Nevada,1/13/2021,259,3148,146,113,0,124,2244,135,452,124
Nevada,1/14/2021,237,3385,125,112,0,219,2446,17,469,219
Nevada,1/15/2021,394,3779,169,225,0,296,2644,98,567,296
Nevada,1/16/2021,296,4075,15,281,0,292,2932,4,571,292
Nevada,1/17/2021,35,4110,31,4,0,33,2963,2,573,33
Nevada,1/18/2021,150,4260,40,110,0,141,3095,9,582,141
Nevada,1/19/2021,238,4498,85,153,0,219,3295,19,601,219
Nevada,1/20/2021,259,4757,153,106,0,246,3528,13,614,246
Nevada,1/21/2021,339,5096,207,132,0,326,3841,13,627,326
Nevada,1/22/2021,347,5443,209,138,0,316,4126,31,658,316
Nevada,1/23/2021,177,5620,104,73,0,177,4303,0,658,177
Nevada,1/24/2021,105,5725,98,7,0,66,4330,39,697,66
Nevada,1/25/2021,267,5992,137,130,0,206,4475,61,758,206
Nevada,1/26/2021,401,6393,141,260,0,299,4672,102,860,299
Nevada,1/27/2021,416,6809,247,169,0,392,5040,24,884,392
Nevada,1/28/2021,466,7275,316,150,0,423,5421,42,926,423
Nevada,1/29/2021,600,7875,391,209,0,577,5976,23,949,578
Nevada,1/30/2021,231,8106,104,127,0,228,6201,3,952,228
Nevada,1/31/2021,103,8209,87,16,0,102,6303,1,953,103
Nevada,2/1/2021,290,8499,71,219,0,276,6565,14,967,276
Nevada,2/2/2021,511,9010,173,338,0,323,6700,188,1155,323
Nevada,2/3/2021,809,9819,569,240,0,757,7406,51,1206,757
Nevada,2/4/2021,737,10556,391,346,0,488,7646,248,1454,488
Nevada,2/5/2021,641,11197,363,278,0,453,7913,186,1640,453
Nevada,2/6/2021,268,11465,82,186,0,241,8127,27,1667,241
Nevada,2/7/2021,245,11710,192,53,0,191,8264,54,1721,191
Nevada,2/8/2021,651,12361,408,243,0,552,8717,99,1820,552
Nevada,2/9/2021,600,12961,336,264,0,462,9041,138,1958,462
Nevada,2/10/2021,646,13607,322,324,0,417,9230,229,2187,418
Nevada,2/11/2021,868,14475,502,366,0,539,9441,328,2515,539
Nevada,2/12/2021,928,15403,434,494,0,611,9736,316,2831,611
Nevada,2/13/2021,596,15999,234,362,0,388,9921,204,3035,389
Nevada,2/14/2021,229,16228,119,110,0,201,10094,28,3063,201
Nevada,2/15/2021,704,16932,438,266,0,534,10458,170,3233,534
Nevada,2/16/2021,619,17551,197,422,0,452,10744,166,3399,452
Nevada,2/17/2021,1185,18736,762,423,0,858,11275,327,3726,858
Nevada,2/18/2021,1005,19741,545,460,0,600,11471,404,4130,600
Nevada,2/19/2021,1009,20750,629,380,0,651,11765,358,4488,652
Nevada,2/20/2021,296,21046,104,192,0,173,11816,122,4610,173
Nevada,2/21/2021,88,21134,83,5,0,8,11745,79,4689,8
Nevada,2/22/2021,494,21628,327,167,0,346,11944,147,4836,346
Nevada,2/23/2021,468,22096,219,249,0,206,11891,259,5095,206
Nevada,2/24/2021,472,22568,234,238,0,248,11917,224,5319,250
Nevada,2/25/2021,859,23427,463,396,0,431,11922,426,5745,431
Nevada,2/26/2021,1234,24661,880,354,0,407,11505,824,6569,407
Nevada,2/27/2021,352,25013,110,242,0,182,11517,170,6739,182
Nevada,2/28/2021,265,25278,153,112,0,124,11501,140,6879,124
Nevada,3/1/2021,815,26093,423,392,0,350,11387,464,7343,350
Nevada,3/2/2021,703,26796,259,444,0,477,11642,222,7565,477
Nevada,3/3/2021,962,27758,489,472,1,491,11664,470,8035,492
Nevada,3/4/2021,1096,28854,609,487,0,464,11499,629,8664,464
Nevada,3/5/2021,814,29668,456,348,10,360,11417,452,9116,370
Nevada,3/6/2021,356,30024,119,210,27,144,11376,212,9328,171
Nevada,3/7/2021,209,30233,110,80,19,68,11322,141,9469,87
Nevada,3/8/2021,804,31037,538,221,45,358,11281,445,9914,404
Nevada,3/9/2021,664,31701,315,299,50,361,11390,301,10215,410
Nevada,3/10/2021,954,32655,603,294,57,319,11135,631,10846,376
Nevada,3/11/2021,1092,33747,718,349,25,539,11154,545,11391,564
Nevada,3/12/2021,1186,34933,720,436,30,502,11003,682,12073,531
Nevada,3/13/2021,264,35197,52,207,5,94,10932,169,12242,98
Nevada,3/14/2021,155,35352,21,128,6,33,10849,122,12364,39
Nevada,3/15/2021,835,36187,453,370,12,353,10735,479,12843,365
Nevada,3/16/2021,994,37181,465,468,61,647,11097,346,13189,708
Nevada,3/17/2021,1012,38193,449,553,10,583,11264,426,13615,593
Nevada,3/18/2021,969,39162,525,421,23,475,11272,490,14105,498
Nevada,3/19/2021,750,39912,437,281,32,351,11259,396,14501,383
Nevada,3/20/2021,822,40734,93,306,423,235,11333,581,15082,655
Nevada,3/21/2021,57,40791,31,25,1,39,11356,17,15099,40
Nevada,3/22/2021,798,41589,514,279,5,540,11645,256,15355,545
Nevada,3/23/2021,848,42437,381,441,26,639,12104,206,15561,665
Nevada,3/24/2021,1015,43452,538,470,7,648,12396,363,15924,655
Nevada,3/25/2021,889,44341,448,416,25,488,12508,400,16324,512
Nevada,3/26/2021,1140,45481,433,670,37,829,13065,308,16632,865
Nevada,3/27/2021,559,46040,70,473,16,378,13278,181,16813,394
Nevada,3/28/2021,174,46214,50,111,13,39,13197,133,16946,52
Nevada,3/29/2021,819,47033,501,296,22,392,13186,424,17370,413
Nevada,3/30/2021,1038,48071,470,534,34,538,13266,492,17862,572
Nevada,3/31/2021,1173,49244,663,493,17,700,13518,464,18326,716
Nevada,4/1/2021,1226,50470,718,455,53,547,13443,675,19001,600
Nevada,4/2/2021,1277,51747,653,588,36,761,13727,513,19514,797
Nevada,4/3/2021,284,52031,86,160,38,79,13640,204,19718,117
Nevada,4/4/2021,128,52159,42,79,7,78,13675,50,19768,85
Nevada,4/5/2021,936,53095,614,303,19,626,14013,307,20075,645
Nevada,4/6/2021,1066,54161,661,262,143,469,14034,591,20666,612
Nevada,4/7/2021,1135,55296,811,242,82,602,14190,527,21193,683
Nevada,4/8/2021,1271,56567,891,297,83,706,14417,562,21755,789
Nevada,4/9/2021,1235,57802,845,321,69,840,14931,395,22150,909
Nevada,4/10/2021,260,58062,80,104,76,114,14976,145,22295,190
Nevada,4/11/2021,99,58161,31,64,4,39,14959,60,22355,43
Nevada,4/12/2021,734,58895,537,180,17,312,14869,419,22774,329
Nevada,4/13/2021,875,59770,349,526,0,468,14932,405,23179,468
Nevada,4/14/2021,1043,60813,562,481,0,538,14973,497,23676,538
Nevada,4/15/2021,1057,61870,703,354,0,615,15156,432,24108,615
Nevada,4/16/2021,896,62766,696,200,0,530,15321,365,24473,530
Nevada,4/17/2021,191,62957,49,142,0,84,15298,107,24580,84
Nevada,4/18/2021,180,63137,17,163,0,100,15318,80,24660,100
Nevada,4/19/2021,750,63887,481,269,0,304,15184,438,25098,304
Nevada,4/20/2021,797,64684,307,490,0,301,14994,491,25589,301
Nevada,4/21/2021,897,65581,493,404,0,265,14635,624,26213,265
Nevada,4/22/2021,953,66534,594,359,0,319,14327,627,26840,319
Nevada,4/23/2021,746,67280,311,435,0,253,14092,488,27328,253
Orange,12/15/2020,16,16,16,0,0,16,16,0,0,16
Orange,12/16/2020,365,381,365,0,0,365,381,0,0,365
Orange,12/17/2020,3724,4105,3724,0,0,3723,4104,0,0,3723
Orange,12/18/2020,5047,9152,5040,7,0,5046,9150,0,0,5046
Orange,12/19/2020,2230,11382,2223,7,0,2229,11379,0,0,2229
Orange,12/20/2020,1983,13365,1981,2,0,1984,13363,0,0,1984
Orange,12/21/2020,4246,17611,4240,6,0,4246,17609,0,0,4246
Orange,12/22/2020,3979,21590,3946,33,0,3979,21588,0,0,3979
Orange,12/23/2020,3561,25151,3199,362,0,3563,25151,0,0,3563
Orange,12/24/2020,1376,26527,1079,297,0,1376,26527,0,0,1376
Orange,12/25/2020,17,26544,12,5,0,17,26544,0,0,17
Orange,12/26/2020,1020,27564,422,598,0,1020,27564,0,0,1020
Orange,12/27/2020,582,28146,275,307,0,582,28146,0,0,582
Orange,12/28/2020,3535,31681,2564,971,0,3535,31681,0,0,3535
Orange,12/29/2020,3566,35247,2562,1004,0,3565,35245,1,1,3565
Orange,12/30/2020,5122,40369,3556,1566,0,5122,40367,0,1,5122
Orange,12/31/2020,1457,41826,759,698,0,1457,41824,0,1,1457
Orange,1/1/2021,484,42310,260,224,0,483,42306,1,2,483
Orange,1/2/2021,1402,43712,893,509,0,1402,43708,0,2,1402
Orange,1/3/2021,573,44285,315,258,0,573,44281,0,2,573
Orange,1/4/2021,2723,47008,1555,1168,0,2724,47004,1,3,2724
Orange,1/5/2021,3507,50515,2285,1222,0,3100,49704,403,406,3103
Orange,1/6/2021,4977,55492,3459,1518,0,3609,51957,1356,1762,3609
Orange,1/7/2021,9243,64735,5157,4086,0,5675,54081,3555,5317,5679
Orange,1/8/2021,9389,74124,5249,4140,0,5637,55978,3742,9059,5639
Orange,1/9/2021,4988,79112,1733,3255,0,3709,58408,1279,10338,3709
Orange,1/10/2021,4231,83343,1041,3190,0,3351,60884,879,11217,3355
Orange,1/11/2021,9429,92772,4895,4534,0,5812,63077,3620,14837,5813
Orange,1/12/2021,8802,101574,4718,4084,0,5338,64954,3462,18299,5339
Orange,1/13/2021,10223,111797,4898,5325,0,7025,68792,3194,21493,7032
Orange,1/14/2021,9951,121748,3768,6183,0,8362,75573,1587,23080,8368
Orange,1/15/2021,10153,131901,2618,7535,0,9281,83979,880,23960,9286
Orange,1/16/2021,8704,140605,2096,6608,0,8308,91896,396,24356,8313
Orange,1/17/2021,8152,148757,1485,6667,0,8007,99767,145,24501,8016
Orange,1/18/2021,9743,158500,4455,5288,0,7503,105029,2243,26744,7505
Orange,1/19/2021,7481,165981,5413,2068,0,4853,107255,2628,29372,4854
Orange,1/20/2021,8270,174251,5815,2455,0,5216,109423,3055,32427,5223
Orange,1/21/2021,10846,185097,4813,6033,0,10054,118695,791,33218,10063
Orange,1/22/2021,13583,198680,5079,8504,0,12749,130626,826,34044,12757
Orange,1/23/2021,13114,211794,6173,6941,0,12144,141810,968,35012,12152
Orange,1/24/2021,9808,221602,4287,5521,0,9491,150990,314,35326,9494
Orange,1/25/2021,10415,232017,5846,4569,0,7706,155997,2704,38030,7711
Orange,1/26/2021,11870,243887,7707,4163,0,9724,163582,2142,40172,9727
Orange,1/27/2021,13400,257287,7989,5411,0,10721,171638,2668,42840,10724
Orange,1/28/2021,13005,270292,7188,5817,0,11152,180958,1840,44680,11160
Orange,1/29/2021,13578,283870,8400,5178,0,10702,188814,2863,47543,10719
Orange,1/30/2021,12926,296796,4444,8482,0,12195,200295,717,48260,12198
Orange,1/31/2021,13710,310506,4943,8767,0,13270,213135,435,48695,13275
Orange,2/1/2021,14017,324523,5773,8244,0,12028,223197,1970,50665,12032
Orange,2/2/2021,15400,339923,8359,7041,0,12660,233228,2632,53297,12663
Orange,2/3/2021,16724,356647,12564,4160,0,13721,244029,2925,56222,13726
Orange,2/4/2021,19800,376447,12941,6859,0,14725,253718,5044,61266,14733
Orange,2/5/2021,20726,397173,12001,8725,0,14462,261956,6226,67492,14464
Orange,2/6/2021,16310,413483,10780,5530,0,11060,267999,5235,72727,11278
Orange,2/7/2021,11516,424999,8099,3417,0,7544,271756,3957,76684,7714
Orange,2/8/2021,14814,439813,8468,6346,0,8820,274613,5964,82648,8821
Orange,2/9/2021,17635,457448,12009,5626,0,10738,278530,6825,89473,10742
Orange,2/10/2021,20882,478330,11168,9714,0,12668,283084,8121,97594,12675
Orange,2/11/2021,21984,500314,11390,10594,0,12378,286000,9480,107074,12396
Orange,2/12/2021,24734,525048,11885,12849,0,14621,290568,10058,117132,14626
Orange,2/13/2021,22003,547051,11907,10096,0,11141,291691,10659,127791,11782
Orange,2/14/2021,16182,563233,6566,9616,0,9549,294632,6609,134400,9550
Orange,2/15/2021,17211,580444,7387,9824,0,8879,295231,8289,142689,8888
Orange,2/16/2021,19895,600339,8971,10924,0,10700,296802,9153,151842,10724
Orange,2/17/2021,17782,618121,9312,8470,0,9161,297415,8579,160421,9192
Orange,2/18/2021,14869,632990,9829,5040,0,6787,296174,8036,168457,6795
Orange,2/19/2021,17828,650818,10722,7106,0,6879,292159,10905,179362,6890
Orange,2/20/2021,7392,658210,5567,1825,0,3746,292289,3626,182988,3756
Orange,2/21/2021,4317,662527,3642,675,0,774,289553,3510,186498,774
Orange,2/22/2021,9597,672124,7836,1761,0,3881,287756,5692,192190,3895
Orange,2/23/2021,13231,685355,7224,6007,0,3481,281551,9696,201886,3491
Orange,2/24/2021,21084,706439,12778,8306,0,5355,271256,15669,217555,5374
Orange,2/25/2021,22564,729003,12224,10340,0,7962,264700,14534,232089,7978
Orange,2/26/2021,27646,756649,14003,13643,0,11134,259455,16403,248492,11158
Orange,2/27/2021,24925,781574,10054,14869,2,7240,249129,17583,266075,7257
Orange,2/28/2021,18988,800562,7343,11645,0,4794,239848,14092,280167,4811
Orange,3/1/2021,18292,818854,8330,9959,3,7055,235750,11168,291335,7070
Orange,3/2/2021,18707,837561,8838,9868,1,9140,235392,9527,300862,9169
Orange,3/3/2021,20102,857663,9329,10770,3,10779,236939,9255,310117,10802
Orange,3/4/2021,22184,879847,12784,9387,13,11495,237817,10655,320772,11533
Orange,3/5/2021,20624,900471,10686,9894,44,12636,242606,7950,328722,12739
Orange,3/6/2021,23826,924297,13079,9885,862,12604,244909,11190,339912,13493
Orange,3/7/2021,14788,939085,8296,6108,384,8630,247818,6126,346038,9035
Orange,3/8/2021,16118,955203,7374,7486,1258,10363,253750,5714,351752,11646
Orange,3/9/2021,19637,974840,8542,8667,2428,11261,259104,8339,360091,13693
Orange,3/10/2021,23914,998754,11699,9063,3152,12092,262577,11769,371860,15242
Orange,3/11/2021,28806,1027560,15662,9034,4110,13392,264747,15330,387190,17500
Orange,3/12/2021,29116,1056676,14191,11105,3820,14630,268810,14411,401601,18474
Orange,3/13/2021,27647,1084323,10118,13613,3916,13992,273115,13604,415205,17909
Orange,3/14/2021,18757,1103080,8127,8118,2512,11844,280582,6885,422090,14352
Orange,3/15/2021,22912,1125992,10076,12081,755,14312,287106,8538,430628,15062
Orange,3/16/2021,26229,1152221,11074,14935,220,17073,295324,9083,439711,17301
Orange,3/17/2021,27097,1179318,13498,13127,472,19376,307511,7660,447371,19847
Orange,3/18/2021,27560,1206878,13840,13449,271,21507,323298,5994,453365,21781
Orange,3/19/2021,33214,1240092,18228,14557,429,24786,340196,8327,461692,25225
Orange,3/20/2021,25646,1265738,13467,11975,204,21967,358745,3621,465313,22170
Orange,3/21/2021,18335,1284073,10642,6966,727,15601,372362,2711,468024,16328
Orange,3/22/2021,22598,1306671,11672,10607,319,19143,388446,3385,471409,19469
Orange,3/23/2021,25815,1332486,13383,11802,630,20778,404885,4971,476380,21410
Orange,3/24/2021,28833,1361319,16084,11869,880,21895,420793,6867,483247,22775
Orange,3/25/2021,32051,1393370,17066,14322,663,24137,437751,7841,491088,24799
Orange,3/26/2021,34575,1427945,17942,15786,847,24940,453992,9543,500631,25784
Orange,3/27/2021,28249,1456194,13504,14431,314,19753,465639,8422,509053,20069
Orange,3/28/2021,24647,1480841,12749,11831,67,18600,478322,5988,515041,18671
Orange,3/29/2021,26310,1507151,12023,13738,549,17912,488455,8329,523370,18462
Orange,3/30/2021,30378,1537529,13760,16235,383,21274,501068,9045,532415,21658
Orange,3/31/2021,36708,1574237,19266,16852,590,24096,513231,12528,544943,24691
Orange,4/1/2021,39629,1613866,20895,17199,1535,25957,527122,13599,558542,27490
Orange,4/2/2021,39423,1653289,19908,17862,1653,22466,534377,16871,575413,24126
Orange,4/3/2021,29542,1682831,15409,12526,1607,14063,534634,15415,590828,15672
Orange,4/4/2021,18183,1701014,10613,6884,686,8153,533482,9990,600818,8838
Orange,4/5/2021,29245,1730259,13873,12149,3223,13791,535091,15400,616218,17009
Orange,4/6/2021,33008,1763267,15490,14213,3305,14338,534135,18589,634807,17633
Orange,4/7/2021,35601,1798868,19944,11231,4426,15740,534496,19790,654597,20151
Orange,4/8/2021,38071,1836939,21144,11606,5321,18570,538956,19413,674010,23873
Orange,4/9/2021,40030,1876969,23292,11713,5025,17671,539361,22279,696289,22684
Orange,4/10/2021,33692,1910661,17789,11785,4118,13964,537777,19653,715942,18069
Orange,4/11/2021,25269,1935930,14233,7827,3209,9693,535135,15535,731477,12893
Orange,4/12/2021,30053,1965983,15260,11352,3441,11842,532240,18164,749641,15269
Orange,4/13/2021,32084,1998067,18021,14002,61,15011,530299,17011,766652,15070
Orange,4/14/2021,33639,2031706,19484,14125,30,14644,526055,18920,785572,14676
Orange,4/15/2021,39084,2070790,23691,15382,11,18094,523255,20907,806479,18107
Orange,4/16/2021,40430,2111220,23588,16817,25,18225,519389,22122,828601,18256
Orange,4/17/2021,29439,2140659,17129,12307,3,12684,515395,16685,845286,12691
Orange,4/18/2021,21190,2161849,12770,8419,1,8369,510990,12778,858064,8373
Orange,4/19/2021,31911,2193760,17432,14477,2,14688,508530,17153,875217,14693
Orange,4/20/2021,34709,2228469,17982,16725,2,17329,508548,17312,892529,17330
Orange,4/21/2021,39365,2267834,22422,16933,10,18279,505832,21005,913534,18289
Orange,4/22/2021,34309,2302143,18583,15721,5,13234,498098,20979,934513,13245
Orange,4/23/2021,21597,2323740,10645,10948,4,9864,496287,11681,946194,9870
Placer,12/15/2020,29,29,29,0,0,29,29,0,0,29
Placer,12/16/2020,54,83,54,0,0,54,83,0,0,54
Placer,12/17/2020,139,222,139,0,0,139,222,0,0,139
Placer,12/18/2020,331,553,331,0,0,331,553,0,0,331
Placer,12/19/2020,251,804,251,0,0,251,804,0,0,251
Placer,12/20/2020,234,1038,234,0,0,234,1038,0,0,234
Placer,12/21/2020,492,1530,491,1,0,492,1530,0,0,492
Placer,12/22/2020,676,2206,669,7,0,676,2206,0,0,676
Placer,12/23/2020,743,2949,658,85,0,743,2949,0,0,743
Placer,12/24/2020,398,3347,346,52,0,398,3347,0,0,398
Placer,12/26/2020,158,3505,113,45,0,158,3505,0,0,158
Placer,12/27/2020,186,3691,163,23,0,186,3691,0,0,186
Placer,12/28/2020,664,4355,537,127,0,664,4355,0,0,664
Placer,12/29/2020,761,5116,513,248,0,761,5116,0,0,761
Placer,12/30/2020,730,5846,454,276,0,728,5844,0,0,728
Placer,12/31/2020,528,6374,343,185,0,528,6372,0,0,528
Placer,1/1/2021,15,6389,11,4,0,15,6387,0,0,15
Placer,1/2/2021,184,6573,152,32,0,184,6571,0,0,184
Placer,1/3/2021,154,6727,79,75,0,154,6725,0,0,154
Placer,1/4/2021,618,7345,179,439,0,618,7343,0,0,618
Placer,1/5/2021,724,8069,159,565,0,641,7903,82,82,642
Placer,1/6/2021,760,8829,244,516,0,618,8379,142,224,618
Placer,1/7/2021,982,9811,366,616,0,777,8951,205,429,777
Placer,1/8/2021,1181,10992,528,653,0,854,9481,324,753,854
Placer,1/9/2021,449,11441,321,128,0,233,9499,215,968,233
Placer,1/10/2021,329,11770,186,143,0,164,9498,165,1133,164
Placer,1/11/2021,1426,13196,808,618,0,837,9747,589,1722,838
Placer,1/12/2021,1645,14841,874,771,0,1043,10188,602,2324,1043
Placer,1/13/2021,1626,16467,818,808,0,1206,10978,418,2742,1208
Placer,1/14/2021,1756,18223,652,1104,0,1401,12028,352,3094,1402
Placer,1/15/2021,1907,20130,723,1184,0,1556,13235,350,3444,1557
Placer,1/16/2021,1471,21601,719,752,0,1350,14465,121,3565,1351
Placer,1/17/2021,562,22163,396,166,0,430,14763,132,3697,430
Placer,1/18/2021,977,23140,540,437,0,747,15281,230,3927,748
Placer,1/19/2021,2571,25711,1947,624,0,2120,16950,451,4378,2120
Placer,1/20/2021,2244,27955,1694,550,0,1916,18539,328,4706,1917
Placer,1/21/2021,2539,30494,1113,1426,0,2145,20292,393,5099,2146
Placer,1/22/2021,2293,32787,591,1702,0,2120,22242,171,5270,2121
Placer,1/23/2021,1189,33976,380,809,0,1034,23121,155,5425,1034
Placer,1/24/2021,507,34483,264,243,0,431,23477,76,5501,432
Placer,1/25/2021,1668,36151,800,868,0,1381,24572,287,5788,1382
Placer,1/26/2021,1847,37998,1026,821,0,1583,25891,264,6052,1583
Placer,1/27/2021,1840,39838,1154,686,0,1597,27248,241,6293,1598
Placer,1/28/2021,1797,41635,1111,686,0,1550,28553,245,6538,1550
Placer,1/29/2021,1886,43521,1171,715,0,1694,30058,191,6729,1696
Placer,1/30/2021,1723,45244,970,753,0,1604,31544,118,6847,1604
Placer,1/31/2021,780,46024,624,156,0,712,32189,68,6915,713
Placer,2/1/2021,2068,48092,1088,980,0,1754,33629,314,7229,1754
Placer,2/2/2021,2367,50459,1535,832,0,1882,35029,482,7711,1882
Placer,2/3/2021,2912,53371,1872,1040,0,2291,36703,617,8328,2291
Placer,2/4/2021,2756,56127,1186,1570,0,1934,37819,819,9147,1935
Placer,2/5/2021,2725,58852,1201,1524,0,1399,37897,1321,10468,1399
Placer,2/6/2021,1944,60796,1307,637,0,1395,38743,549,11017,1395
Placer,2/7/2021,1218,62014,908,310,0,937,39400,280,11297,937
Placer,2/8/2021,3299,65313,1767,1532,0,1975,40060,1316,12613,1976
Placer,2/9/2021,3539,68852,2167,1372,0,1635,39793,1902,14515,1635
Placer,2/10/2021,3745,72597,2190,1555,0,1745,39543,1997,16512,1747
Placer,2/11/2021,3612,76209,1892,1720,0,1569,39078,2035,18547,1570
Placer,2/12/2021,2749,78958,1317,1432,0,1653,39653,1079,19626,1654
Placer,2/13/2021,2533,81491,1484,1049,0,1882,40884,651,20277,1882
Placer,2/14/2021,1075,82566,674,401,0,735,41282,337,20614,735
Placer,2/15/2021,2179,84745,1042,1137,0,1520,42143,660,21274,1521
Placer,2/16/2021,3537,88282,1778,1759,0,1579,41774,1949,23223,1580
Placer,2/17/2021,3536,91818,1961,1575,0,1506,41254,2026,25249,1506
Placer,2/18/2021,3702,95520,1999,1703,0,1578,40718,2115,27364,1579
Placer,2/19/2021,3565,99085,1910,1655,0,1318,39794,2243,29607,1319
Placer,2/20/2021,1970,101055,1230,740,0,886,39605,1078,30685,889
Placer,2/21/2021,970,102025,728,242,0,278,39195,689,31374,279
Placer,2/22/2021,2513,104538,1768,745,0,601,37885,1911,33285,601
Placer,2/23/2021,2531,107069,1564,967,0,876,37107,1654,34939,876
Placer,2/24/2021,3257,110326,1173,2084,0,1778,37418,1469,36408,1780
Placer,2/25/2021,3472,113798,1423,2049,0,1838,37630,1627,38035,1839
Placer,2/26/2021,4089,117887,2372,1717,0,2349,38243,1736,39771,2349
Placer,2/27/2021,2813,120700,1492,1321,0,1449,38337,1358,41129,1452
Placer,2/28/2021,1389,122089,790,599,0,580,38114,803,41932,580
Placer,3/1/2021,2984,125073,1985,999,0,1536,38207,1443,43375,1536
Placer,3/2/2021,2865,127938,1760,1105,0,1876,39099,984,44359,1876
Placer,3/3/2021,3291,131229,1400,1891,0,1794,39403,1491,45850,1795
Placer,3/4/2021,3563,134792,1425,2138,0,1850,39553,1701,47551,1851
Placer,3/5/2021,2989,137781,1024,1943,22,1792,40172,1195,48746,1814
Placer,3/6/2021,2396,140177,1481,819,96,919,39717,1470,50216,1015
Placer,3/7/2021,1294,141471,755,501,38,526,39516,765,50981,564
Placer,3/8/2021,2908,144379,1827,968,113,1651,40024,1256,52237,1764
Placer,3/9/2021,3160,147539,1678,1392,90,1809,40575,1348,53585,1899
Placer,3/10/2021,3266,150805,1314,1845,107,1703,40827,1558,55143,1810
Placer,3/11/2021,3541,154346,1587,1830,124,1702,40824,1831,56974,1828
Placer,3/12/2021,3664,158010,1479,1405,780,1248,40443,2410,59384,2029
Placer,3/13/2021,2103,160113,737,1248,118,1130,40722,970,60354,1249
Placer,3/14/2021,1635,161748,672,814,149,889,41015,745,61099,1038
Placer,3/15/2021,3171,164919,1527,1513,131,1758,41495,1411,62510,1891
Placer,3/16/2021,3545,168464,1910,1502,133,2277,42647,1259,63769,2411
Placer,3/17/2021,3393,171857,1724,1570,99,2198,43753,1193,64962,2299
Placer,3/18/2021,3952,175809,2195,1719,38,2816,45476,1130,66092,2853
Placer,3/19/2021,3409,179218,2060,1085,264,2174,46685,1228,67320,2437
Placer,3/20/2021,2134,181352,895,1142,97,1304,47259,826,68146,1400
Placer,3/21/2021,1245,182597,571,665,9,938,47902,304,68450,947
Placer,3/22/2021,3261,185858,2096,1078,87,2191,49115,1066,69516,2279
Placer,3/23/2021,3516,189374,2090,1335,91,2521,50738,990,70506,2613
Placer,3/24/2021,3759,193133,1998,1664,97,1955,50998,1792,72298,2052
Placer,3/25/2021,3769,196902,1795,1877,97,1724,50782,2036,74334,1820
Placer,3/26/2021,3740,200642,1654,1854,232,1581,50446,2149,76483,1813
Placer,3/27/2021,1591,202233,469,1102,20,647,50176,937,77420,667
Placer,3/28/2021,1095,203328,526,559,10,368,49832,722,78142,378
Placer,3/29/2021,3546,206874,1982,1530,34,1720,49771,1816,79958,1755
Placer,3/30/2021,3982,210856,2111,1827,44,2105,50055,1864,81822,2148
Placer,3/31/2021,4057,214913,1829,2154,74,1687,49452,2363,84185,1760
Placer,4/1/2021,2860,217773,1366,1449,45,1592,49823,1266,85451,1637
Placer,4/2/2021,2781,220554,1438,1279,64,1552,50217,1221,86672,1615
Placer,4/3/2021,1854,222408,983,741,130,891,50281,956,87628,1020
Placer,4/4/2021,706,223114,360,293,53,284,50198,420,88048,337
Placer,4/5/2021,2988,226102,1892,914,182,1744,50884,1240,89288,1926
Placer,4/6/2021,4263,230365,2466,1499,298,1520,49964,2738,92026,1818
Placer,4/7/2021,4484,234849,2563,1461,460,2049,50042,2429,94455,2507
Placer,4/8/2021,4666,239515,2590,1532,544,1571,49074,3083,97538,2115
Placer,4/9/2021,4054,243569,2238,1203,613,1205,48052,2842,100380,1820
Placer,4/10/2021,1975,245544,854,943,178,845,47947,1127,101507,1022
Placer,4/11/2021,1311,246855,500,778,33,425,47522,882,102389,457
Placer,4/12/2021,4101,250956,2652,1069,380,2469,48747,1623,104012,2848
Placer,4/13/2021,4332,255288,2985,1346,1,2188,48796,2140,106152,2189
Placer,4/14/2021,4054,259342,2506,1547,1,1794,48339,2251,108403,1794
Placer,4/15/2021,4379,263721,2422,1956,1,2276,48521,2095,110498,2277
Placer,4/16/2021,3625,267346,2148,1477,0,1419,47740,2200,112698,1419
Placer,4/17/2021,2318,269664,781,1537,0,1442,48309,873,113571,1442
Placer,4/18/2021,1143,270807,223,920,0,398,47965,742,114313,398
Placer,4/19/2021,2866,273673,1752,1114,0,1137,47377,1726,116039,1138
Placer,4/20/2021,3741,277414,2420,1321,0,2380,48404,1353,117392,2380
Placer,4/21/2021,3589,281003,2360,1228,1,2337,49495,1247,118639,2338
Placer,4/22/2021,2974,283977,1854,1120,0,1508,49540,1464,120103,1509
Placer,4/23/2021,963,284940,521,441,1,532,49643,430,120533,533
Plumas,12/18/2020,4,4,4,0,0,4,4,0,0,4
Plumas,12/19/2020,1,5,1,0,0,1,5,0,0,1
Plumas,12/21/2020,45,50,45,0,0,45,50,0,0,45
Plumas,12/22/2020,92,142,92,0,0,92,142,0,0,92
Plumas,12/23/2020,50,192,50,0,0,50,192,0,0,50
Plumas,12/24/2020,6,198,6,0,0,6,198,0,0,6
Plumas,12/28/2020,8,206,0,8,0,8,206,0,0,8
Plumas,12/29/2020,32,238,22,10,0,32,238,0,0,32
Plumas,12/30/2020,22,260,1,21,0,22,260,0,0,22
Plumas,12/31/2020,4,264,1,3,0,4,264,0,0,4
Plumas,1/4/2021,10,274,4,6,0,10,274,0,0,10
Plumas,1/5/2021,22,296,2,20,0,22,296,0,0,22
Plumas,1/6/2021,124,420,5,119,0,124,420,0,0,124
Plumas,1/7/2021,53,473,2,51,0,52,471,1,1,52
Plumas,1/8/2021,12,485,5,7,0,8,475,4,5,8
Plumas,1/9/2021,2,487,2,0,0,1,475,1,6,1
Plumas,1/11/2021,59,546,50,9,0,12,440,47,53,12
Plumas,1/12/2021,155,701,86,69,0,71,427,84,137,71
Plumas,1/13/2021,56,757,50,6,0,10,391,46,183,10
Plumas,1/14/2021,96,853,14,82,0,91,477,5,188,91
Plumas,1/15/2021,62,915,7,55,0,60,535,2,190,60
Plumas,1/16/2021,58,973,1,57,0,58,593,0,190,58
Plumas,1/18/2021,2,975,1,1,0,2,595,0,190,2
Plumas,1/19/2021,36,1011,5,31,0,32,623,4,194,32
Plumas,1/20/2021,121,1132,3,118,0,119,740,2,196,119
Plumas,1/21/2021,113,1245,2,111,0,113,853,0,196,113
Plumas,1/22/2021,4,1249,0,4,0,4,857,0,196,4
Plumas,1/23/2021,92,1341,1,91,0,92,949,0,196,92
Plumas,1/24/2021,1,1342,1,0,0,1,950,0,196,1
Plumas,1/25/2021,10,1352,7,3,0,7,954,3,199,7
Plumas,1/26/2021,60,1412,2,58,0,52,998,8,207,52
Plumas,1/27/2021,25,1437,20,5,0,5,983,20,227,5
Plumas,1/28/2021,23,1460,0,23,0,21,1002,2,229,21
Plumas,1/29/2021,8,1468,2,6,0,7,1008,1,230,7
Plumas,1/30/2021,8,1476,4,4,0,7,1014,1,231,7
Plumas,1/31/2021,3,1479,3,0,0,3,1017,0,231,3
Plumas,2/1/2021,15,1494,2,13,0,7,1016,8,239,7
Plumas,2/2/2021,20,1514,1,19,0,1,998,19,258,1
Plumas,2/3/2021,128,1642,8,120,0,13,897,114,372,13
Plumas,2/4/2021,101,1743,8,93,0,23,842,78,450,23
Plumas,2/5/2021,24,1767,11,13,0,9,836,15,465,9
Plumas,2/6/2021,7,1774,0,7,0,7,843,0,465,7
Plumas,2/8/2021,16,1790,7,9,0,4,835,12,477,4
Plumas,2/9/2021,171,1961,1,170,0,111,886,60,537,111
Plumas,2/10/2021,89,2050,9,80,0,80,958,9,546,81
Plumas,2/11/2021,322,2372,7,315,0,263,1162,59,605,263
Plumas,2/12/2021,122,2494,3,119,0,118,1276,4,609,118
Plumas,2/13/2021,73,2567,4,69,0,14,1231,59,668,14
Plumas,2/14/2021,8,2575,5,3,0,8,1239,0,668,8
Plumas,2/15/2021,28,2603,5,23,0,25,1261,3,671,25
Plumas,2/16/2021,76,2679,4,72,0,14,1213,62,733,14
Plumas,2/17/2021,136,2815,5,131,0,12,1101,124,857,12
Plumas,2/18/2021,128,2943,6,122,0,19,1011,109,966,19
Plumas,2/19/2021,41,2984,4,37,0,6,982,35,1001,6
Plumas,2/20/2021,103,3087,6,97,0,11,901,92,1093,11
Plumas,2/21/2021,6,3093,5,1,0,2,899,4,1097,2
Plumas,2/22/2021,3,3096,1,2,0,0,896,3,1100,0
Plumas,2/23/2021,24,3120,4,20,0,16,904,8,1108,16
Plumas,2/24/2021,456,3576,6,450,0,443,1334,13,1121,443
Plumas,2/25/2021,231,3807,9,222,0,171,1445,60,1181,171
Plumas,2/26/2021,264,4071,8,256,0,256,1694,8,1189,257
Plumas,2/27/2021,41,4112,4,37,0,34,1721,7,1196,34
Plumas,2/28/2021,1,4113,0,1,0,1,1722,0,1196,1
Plumas,3/1/2021,12,4125,3,9,0,7,1725,4,1200,7
Plumas,3/2/2021,8,4133,0,8,0,6,1729,2,1202,6
Plumas,3/3/2021,152,4285,10,142,0,136,1849,16,1218,136
Plumas,3/4/2021,250,4535,9,241,0,229,2057,21,1239,229
Plumas,3/5/2021,397,4932,6,386,5,386,2437,11,1250,391
Plumas,3/6/2021,17,4949,2,7,8,3,2434,14,1264,11
Plumas,3/7/2021,13,4962,2,2,9,3,2436,10,1274,12
Plumas,3/8/2021,29,4991,3,2,24,3,2437,26,1300,27
Plumas,3/9/2021,132,5123,1,116,15,18,2356,114,1414,33
Plumas,3/10/2021,255,5378,3,238,14,108,2332,146,1560,122
Plumas,3/11/2021,181,5559,8,168,5,146,2448,35,1595,151
Plumas,3/12/2021,595,6154,3,304,288,23,2187,572,2167,311
Plumas,3/13/2021,25,6179,4,10,11,5,2183,20,2187,16
Plumas,3/14/2021,12,6191,3,4,5,1,2179,10,2197,6
Plumas,3/15/2021,34,6225,1,26,7,7,2166,27,2224,14
Plumas,3/16/2021,59,6284,2,56,1,49,2206,10,2234,50
Plumas,3/17/2021,74,6358,10,63,1,59,2252,14,2248,60
Plumas,3/18/2021,57,6415,6,34,17,8,2228,49,2297,25
Plumas,3/19/2021,164,6579,6,156,2,155,2379,7,2304,158
Plumas,3/20/2021,693,7272,4,688,1,672,3033,19,2323,673
Plumas,3/21/2021,2,7274,1,1,0,1,3034,0,2323,1
Plumas,3/22/2021,182,7456,2,180,0,175,3202,7,2330,175
Plumas,3/23/2021,27,7483,2,25,0,13,3201,14,2344,13
Plumas,3/24/2021,650,8133,7,642,1,220,2993,429,2773,221
Plumas,3/25/2021,291,8424,5,284,2,151,3004,140,2913,151
Plumas,3/26/2021,307,8731,7,300,0,45,2788,261,3174,45
Plumas,3/27/2021,12,8743,1,10,1,2,2781,10,3184,3
Plumas,3/28/2021,5,8748,3,1,1,3,2783,2,3186,4
Plumas,3/29/2021,13,8761,4,8,1,5,2781,8,3194,6
Plumas,3/30/2021,151,8912,3,147,1,24,2679,127,3321,25
Plumas,3/31/2021,287,9199,2,284,1,268,2929,19,3340,269
Plumas,4/1/2021,291,9490,12,279,0,59,2757,231,3571,59
Plumas,4/2/2021,373,9863,4,368,1,27,2451,334,3905,28
Plumas,4/3/2021,16,9879,2,6,8,3,2449,13,3918,11
Plumas,4/4/2021,3,9882,1,1,1,0,2447,3,3921,1
Plumas,4/5/2021,13,9895,4,8,1,6,2447,7,3928,7
Plumas,4/6/2021,120,10015,6,83,31,13,2379,107,4035,39
Plumas,4/7/2021,281,10296,7,99,175,27,2327,254,4289,202
Plumas,4/8/2021,149,10445,3,131,15,34,2261,114,4403,48
Plumas,4/9/2021,50,10495,9,25,16,19,2264,31,4434,34
Plumas,4/10/2021,23,10518,2,5,16,4,2265,19,4453,20
Plumas,4/11/2021,4,10522,3,0,1,3,2268,1,4454,4
Plumas,4/12/2021,10,10532,4,4,2,6,2272,4,4458,8
Plumas,4/13/2021,207,10739,5,202,0,138,2341,69,4527,138
Plumas,4/14/2021,108,10847,7,101,0,54,2341,54,4581,54
Plumas,4/15/2021,48,10895,3,45,0,33,2359,15,4596,33
Plumas,4/16/2021,144,11039,4,140,0,4,2223,140,4736,4
Plumas,4/17/2021,665,11704,1,664,0,20,1600,643,5379,20
Plumas,4/18/2021,3,11707,2,1,0,1,1599,2,5381,1
Plumas,4/19/2021,38,11745,3,35,0,5,1571,33,5414,5
Plumas,4/20/2021,40,11785,4,36,0,25,1581,15,5429,25
Plumas,4/21/2021,237,12022,5,227,5,17,1379,219,5648,17
Plumas,4/22/2021,264,12286,7,257,0,131,1377,133,5781,131
Plumas,4/23/2021,54,12340,1,53,0,2,1327,52,5833,2
Riverside,12/15/2020,4,4,4,0,0,4,4,0,0,4
Riverside,12/16/2020,64,68,64,0,0,64,68,0,0,64
Riverside,12/17/2020,805,873,805,0,0,805,873,0,0,805
Riverside,12/18/2020,1725,2598,1724,1,0,1725,2598,0,0,1725
Riverside,12/19/2020,1026,3624,1023,3,0,1024,3621,1,1,1024
Riverside,12/20/2020,1084,4708,1083,1,0,1084,4705,0,1,1084
Riverside,12/21/2020,2272,6980,2270,2,0,2272,6977,0,1,2272
Riverside,12/22/2020,2251,9231,2212,39,0,2250,9227,0,1,2250
Riverside,12/23/2020,2127,11358,1791,336,0,2128,11355,0,1,2128
Riverside,12/24/2020,826,12184,624,202,0,826,12181,0,1,826
Riverside,12/25/2020,28,12212,5,23,0,28,12209,0,1,28
Riverside,12/26/2020,400,12612,257,143,0,400,12609,0,1,400
Riverside,12/27/2020,361,12973,243,118,0,361,12970,0,1,361
Riverside,12/28/2020,1626,14599,1126,500,0,1626,14596,0,1,1626
Riverside,12/29/2020,1735,16334,972,763,0,1735,16331,0,1,1735
Riverside,12/30/2020,2571,18905,1680,891,0,2570,18901,0,1,2570
Riverside,12/31/2020,1022,19927,394,628,0,1024,19925,0,1,1024
Riverside,1/1/2021,107,20034,42,65,0,107,20032,0,1,107
Riverside,1/2/2021,830,20864,691,139,0,830,20862,0,1,830
Riverside,1/3/2021,345,21209,300,45,0,344,21206,0,1,344
Riverside,1/4/2021,1257,22466,792,465,0,1257,22463,0,1,1257
Riverside,1/5/2021,1978,24444,1362,616,0,1884,24259,88,89,1884
Riverside,1/6/2021,2474,26918,1103,1371,0,2168,26125,302,391,2168
Riverside,1/7/2021,2767,29685,1814,953,0,1704,26772,1059,1450,1706
Riverside,1/8/2021,4045,33730,2936,1109,0,2233,27197,1808,3258,2233
Riverside,1/9/2021,2068,35798,845,1223,0,1722,28574,345,3603,1722
Riverside,1/10/2021,1663,37461,734,929,0,1060,29031,603,4206,1060
Riverside,1/11/2021,4509,41970,3094,1415,0,2777,30079,1730,5936,2778
Riverside,1/12/2021,3402,45372,2730,672,0,1715,30112,1682,7618,1715
Riverside,1/13/2021,4382,49754,2868,1514,0,2779,31291,1600,9218,2779
Riverside,1/14/2021,5463,55217,1866,3597,0,4877,35582,586,9804,4877
Riverside,1/15/2021,6139,61356,2092,4047,0,5852,41148,286,10090,5852
Riverside,1/16/2021,3610,64966,1017,2593,0,3365,44269,245,10335,3366
Riverside,1/17/2021,3590,68556,582,3008,0,3395,47470,194,10529,3395
Riverside,1/18/2021,3717,72273,2018,1699,0,2712,49177,1005,11534,2712
Riverside,1/19/2021,7399,79672,2637,4762,0,6281,54341,1118,12652,6282
Riverside,1/20/2021,7955,87627,2873,5082,0,6473,59345,1473,14125,6477
Riverside,1/21/2021,8215,95842,3378,4837,0,7601,66331,615,14740,7601
Riverside,1/22/2021,8701,104543,2963,5738,0,8273,74179,426,15166,8274
Riverside,1/23/2021,5921,110464,2393,3528,0,5193,78645,728,15894,5194
Riverside,1/24/2021,3032,113496,1430,1602,0,2819,81255,210,16104,2820
Riverside,1/25/2021,7872,121368,4534,3338,0,6749,86883,1122,17226,6750
Riverside,1/26/2021,9118,130486,5735,3383,0,7606,92980,1510,18736,7607
Riverside,1/27/2021,10831,141317,6353,4478,0,9269,100693,1559,20295,9272
Riverside,1/28/2021,11407,152724,6714,4693,0,10251,109797,1148,21443,10252
Riverside,1/29/2021,11848,164572,7230,4618,0,10480,118942,1341,22784,10486
Riverside,1/30/2021,9042,173614,4606,4436,0,8581,127066,458,23242,8582
Riverside,1/31/2021,5146,178760,4242,904,0,5014,131953,131,23373,5018
Riverside,2/1/2021,10840,189600,6698,4142,0,9063,139248,1771,25144,9066
Riverside,2/2/2021,9501,199101,4849,4652,0,8019,145794,1475,26619,8021
Riverside,2/3/2021,11994,211095,4975,7019,0,9766,153342,2218,28837,9766
Riverside,2/4/2021,13545,224640,6045,7500,0,11457,162720,2081,30918,11459
Riverside,2/5/2021,14313,238953,5396,8917,0,11277,170973,3028,33946,11281
Riverside,2/6/2021,7252,246205,4282,2970,0,5614,174960,1630,35576,5617
Riverside,2/7/2021,2162,248367,792,1370,0,1846,176492,315,35891,1847
Riverside,2/8/2021,12437,260804,5526,6911,0,10157,184389,2263,38154,10160
Riverside,2/9/2021,9637,270441,4522,5115,0,7723,190211,1906,40060,7728
Riverside,2/10/2021,12050,282491,6975,5075,0,8900,195981,3138,43198,8908
Riverside,2/11/2021,16547,299038,9032,7515,0,12170,203810,4355,47553,12184
Riverside,2/12/2021,17662,316700,10812,6850,0,12825,211851,4794,52347,12835
Riverside,2/13/2021,6317,323017,2124,4193,0,3089,211751,3210,55557,3110
Riverside,2/14/2021,4925,327942,1122,3803,0,2175,211181,2746,58303,2176
Riverside,2/15/2021,9805,337747,4995,4810,0,5400,212190,4398,62701,5407
Riverside,2/16/2021,16100,353847,10107,5993,0,9250,214603,6844,69545,9257
Riverside,2/17/2021,14996,368843,8192,6804,0,7438,214504,7546,77091,7447
Riverside,2/18/2021,15466,384309,8938,6528,0,8052,215172,7397,84488,8065
Riverside,2/19/2021,15233,399542,8212,7021,0,7208,214382,8006,92494,7216
Riverside,2/20/2021,8056,407598,4252,3804,0,2089,210522,5952,98446,2092
Riverside,2/21/2021,3407,411005,2893,514,0,1025,209178,2369,100815,1025
Riverside,2/22/2021,12316,423321,7736,4580,0,5094,207072,7205,108020,5099
Riverside,2/23/2021,11065,434386,7543,3522,0,5379,206796,5659,113679,5383
Riverside,2/24/2021,14784,449170,8092,6692,0,6301,204670,8444,122123,6318
Riverside,2/25/2021,17283,466453,7358,9925,0,8019,203471,9243,131366,8044
Riverside,2/26/2021,18546,484999,6689,11857,0,9267,203547,9223,140589,9299
Riverside,2/27/2021,11343,496342,4908,6435,0,5664,203590,5647,146236,5690
Riverside,2/28/2021,4611,500953,2947,1664,0,2375,203746,2226,148462,2382
Riverside,3/1/2021,14260,515213,6070,8189,1,8415,206372,5817,154279,8443
Riverside,3/2/2021,15250,530463,7428,7821,1,8962,209097,6266,160545,8991
Riverside,3/3/2021,16714,547177,8262,8452,0,7168,206891,9499,170044,7293
Riverside,3/4/2021,18534,565711,7387,11143,4,8792,206137,9700,179744,8946
Riverside,3/5/2021,18675,584386,7486,11145,44,9245,206321,9380,189124,9564
Riverside,3/6/2021,9373,593759,4964,3931,478,4654,206778,4705,193829,5162
Riverside,3/7/2021,4166,597925,2692,1086,388,1956,206925,2201,196030,2348
Riverside,3/8/2021,11898,609823,4732,6765,401,5301,206093,6581,202611,5749
Riverside,3/9/2021,14628,624451,6754,7379,495,5771,203656,8841,211452,6404
Riverside,3/10/2021,15559,640010,8358,6326,875,5991,201141,9534,220986,7019
Riverside,3/11/2021,19146,659156,9414,7897,1835,7545,199162,11569,232555,9590
Riverside,3/12/2021,21073,680229,7906,8483,4684,7080,197294,13963,246518,12095
Riverside,3/13/2021,8334,688563,2500,4666,1168,4282,198790,4033,250551,5529
Riverside,3/14/2021,4597,693160,1577,1731,1289,2039,199567,2548,253099,3325
Riverside,3/15/2021,18596,711756,7831,9096,1669,9137,201053,9421,262520,10907
Riverside,3/16/2021,20843,732599,10103,9927,813,11360,203874,9446,271966,12267
Riverside,3/17/2021,21225,753824,10880,9298,1047,12747,209283,8447,280413,13856
Riverside,3/18/2021,22517,776341,11701,9164,1652,12501,213471,9973,290386,14161
Riverside,3/19/2021,23976,800317,12564,10464,948,14027,218908,9900,300286,15337
Riverside,3/20/2021,10569,810886,6831,2577,1161,6808,223140,3738,304024,7970
Riverside,3/21/2021,3669,814555,2865,551,253,2520,224778,1136,305160,2774
Riverside,3/22/2021,16596,831151,9900,6144,552,10585,229940,5972,311132,11134
Riverside,3/23/2021,18509,849660,10478,7610,421,11940,235797,6521,317653,12378
Riverside,3/24/2021,18623,868283,10381,8123,119,12826,242993,5755,323408,12951
Riverside,3/25/2021,21064,889347,11632,9256,176,14205,250584,6795,330203,14386
Riverside,3/26/2021,24015,913362,11852,11991,172,15003,256838,8925,339128,15179
Riverside,3/27/2021,9220,922582,4842,3324,1054,4760,258209,4444,343572,5815
Riverside,3/28/2021,4722,927304,3106,1524,92,2841,259270,1873,345445,2934
Riverside,3/29/2021,17522,944826,8421,8984,117,10896,263699,6594,352039,11023
Riverside,3/30/2021,18270,963096,9530,8537,203,11776,269219,6462,358501,11982
Riverside,3/31/2021,17950,981046,8364,9285,301,11488,274595,6423,364924,11799
Riverside,4/1/2021,25258,1006304,12361,12156,741,16421,282968,8788,373712,17161
Riverside,4/2/2021,25902,1032206,13986,10990,926,16320,290909,9534,383246,17475
Riverside,4/3/2021,9086,1041292,5752,2774,560,5865,294128,3205,386451,6424
Riverside,4/4/2021,3334,1044626,2039,1077,218,1743,294502,1587,388038,1961
Riverside,4/5/2021,18079,1062705,9357,6906,1816,9827,297925,8223,396261,11646
Riverside,4/6/2021,23534,1086239,12242,9210,2082,13115,302746,10372,406633,15193
Riverside,4/7/2021,24447,1110686,13170,8826,2451,13650,308091,10758,417391,16103
Riverside,4/8/2021,26869,1137555,14793,9169,2907,16400,316977,10409,427800,19295
Riverside,4/9/2021,25927,1163482,15300,8243,2384,15857,325214,10026,437826,18263
Riverside,4/10/2021,11706,1175188,6586,3742,1378,5047,325018,6618,444444,6422
Riverside,4/11/2021,4537,1179725,2720,1233,584,2158,325392,2368,446812,2742
Riverside,4/12/2021,19895,1199620,8886,8441,2568,10009,328123,9848,456660,12579
Riverside,4/13/2021,19719,1219339,11116,8575,28,11274,331024,8403,465063,11304
Riverside,4/14/2021,21844,1241183,12053,9778,13,10705,330664,11082,476145,10722
Riverside,4/15/2021,21264,1262447,11958,9299,7,11085,331635,10123,486268,11094
Riverside,4/16/2021,24318,1286765,13968,10344,6,11288,329953,12983,499251,11301
Riverside,4/17/2021,9784,1296549,6435,3349,0,4950,330089,4820,504071,4956
Riverside,4/18/2021,3581,1300130,2537,1037,7,1701,329931,1868,505939,1710
Riverside,4/19/2021,18769,1318899,10972,7795,2,6578,324360,12155,518094,6584
Riverside,4/20/2021,17965,1336864,9289,8666,10,7272,320986,10659,528753,7285
Riverside,4/21/2021,18949,1355813,10827,8115,7,7471,317047,11423,540176,7484
Riverside,4/22/2021,17938,1373751,10931,7004,3,6324,311816,11562,551738,6331
Riverside,4/23/2021,12477,1386228,8160,4307,10,4285,307947,8169,559907,4300
Sacramento,12/15/2020,314,314,314,0,0,314,314,0,0,314
Sacramento,12/16/2020,643,957,643,0,0,643,957,0,0,643
Sacramento,12/17/2020,645,1602,645,0,0,645,1602,0,0,645
Sacramento,12/18/2020,972,2574,972,0,0,972,2574,0,0,972
Sacramento,12/19/2020,612,3186,612,0,0,612,3186,0,0,612
Sacramento,12/20/2020,633,3819,633,0,0,633,3819,0,0,633
Sacramento,12/21/2020,1679,5498,1678,1,0,1680,5499,0,0,1680
Sacramento,12/22/2020,2092,7590,2062,30,0,2092,7591,0,0,2092
Sacramento,12/23/2020,2247,9837,2080,167,0,2247,9838,0,0,2247
Sacramento,12/24/2020,1044,10881,833,211,0,1044,10882,0,0,1044
Sacramento,12/25/2020,1,10882,0,1,0,1,10883,0,0,1
Sacramento,12/26/2020,508,11390,291,217,0,508,11391,0,0,508
Sacramento,12/27/2020,350,11740,247,103,0,350,11741,0,0,350
Sacramento,12/28/2020,1902,13642,1323,579,0,1901,13641,1,1,1901
Sacramento,12/29/2020,1951,15593,1189,762,0,1951,15592,0,1,1951
Sacramento,12/30/2020,2558,18151,1456,1102,0,2559,18151,0,1,2559
Sacramento,12/31/2020,1229,19380,695,534,0,1229,19380,0,1,1229
Sacramento,1/1/2021,77,19457,68,9,0,77,19457,0,1,77
Sacramento,1/2/2021,563,20020,362,201,0,563,20020,0,1,563
Sacramento,1/3/2021,409,20429,220,189,0,409,20429,0,1,409
Sacramento,1/4/2021,1958,22387,845,1113,0,1956,22384,1,2,1956
Sacramento,1/5/2021,2210,24597,986,1224,0,1856,23893,354,356,1863
Sacramento,1/6/2021,2732,27329,1623,1109,0,1958,25080,771,1127,1958
Sacramento,1/7/2021,2825,30154,1503,1322,0,1966,26190,856,1983,1966
Sacramento,1/8/2021,3285,33439,2085,1200,0,2248,27406,1033,3016,2249
Sacramento,1/9/2021,1287,34726,796,491,0,897,27915,388,3404,897
Sacramento,1/10/2021,1246,35972,711,535,0,774,28219,471,3875,775
Sacramento,1/11/2021,4342,40314,2952,1390,0,2412,28707,1929,5804,2417
Sacramento,1/12/2021,4422,44736,3033,1389,0,2456,29202,1965,7769,2460
Sacramento,1/13/2021,3780,48516,2167,1613,0,2370,30165,1409,9178,2372
Sacramento,1/14/2021,4599,53115,2364,2235,0,3676,32922,919,10097,3676
Sacramento,1/15/2021,4408,57523,2263,2145,0,3684,35885,723,10820,3686
Sacramento,1/16/2021,2093,59616,1293,800,0,1876,37544,217,11037,1876
Sacramento,1/17/2021,1637,61253,952,685,0,1459,38828,178,11215,1462
Sacramento,1/18/2021,2857,64110,1764,1093,0,2332,40637,524,11739,2333
Sacramento,1/19/2021,4626,68736,3053,1573,0,3361,42734,1265,13004,3362
Sacramento,1/20/2021,4770,73506,2822,1948,0,3554,45075,1218,14222,3559
Sacramento,1/21/2021,5184,78690,2987,2197,0,4222,48342,956,15178,4223
Sacramento,1/22/2021,4970,83660,2647,2323,0,4668,52710,301,15479,4669
Sacramento,1/23/2021,3726,87386,1559,2167,0,3269,55522,457,15936,3269
Sacramento,1/24/2021,1583,88969,992,591,0,1343,56626,240,16176,1344
Sacramento,1/25/2021,4356,93325,2109,2247,0,2940,58152,1416,17592,2942
Sacramento,1/26/2021,4718,98043,2134,2584,0,3516,60470,1200,18792,3518
Sacramento,1/27/2021,5799,103842,3049,2750,0,4193,63062,1603,20395,4195
Sacramento,1/28/2021,5353,109195,2706,2647,0,4258,66227,1094,21489,4259
Sacramento,1/29/2021,5384,114579,2932,2452,0,4369,69589,1007,22496,4369
Sacramento,1/30/2021,4506,119085,2203,2303,0,4072,73229,432,22928,4072
Sacramento,1/31/2021,2294,121379,1999,295,0,2019,74977,273,23201,2021
Sacramento,2/1/2021,5906,127285,3010,2896,0,4248,77571,1654,24855,4248
Sacramento,2/2/2021,6922,134207,3758,3164,0,4843,80355,2061,26916,4845
Sacramento,2/3/2021,7086,141293,3549,3537,0,5226,83733,1850,28766,5228
Sacramento,2/4/2021,7702,148995,3628,4074,0,5490,87021,2202,30968,5490
Sacramento,2/5/2021,7715,156710,4366,3349,0,4808,88948,2884,33852,4811
Sacramento,2/6/2021,8423,165133,3443,4980,0,7094,94718,1325,35177,7095
Sacramento,2/7/2021,4052,169185,2169,1883,0,2833,96342,1211,36388,2835
Sacramento,2/8/2021,6191,175376,3198,2993,0,3884,97923,2303,38691,3884
Sacramento,2/9/2021,6713,182089,3503,3210,0,3922,99064,2782,41473,3923
Sacramento,2/10/2021,7659,189748,4181,3478,0,4539,100498,3107,44580,4541
Sacramento,2/11/2021,8783,198531,4988,3795,0,4795,101319,3976,48556,4797
Sacramento,2/12/2021,10570,209101,4136,6434,0,6380,103552,4150,52706,6383
Sacramento,2/13/2021,7597,216698,2989,4608,0,6018,107993,1577,54283,6018
Sacramento,2/14/2021,3117,219815,1930,1187,0,2069,109020,1046,55329,2073
Sacramento,2/15/2021,5943,225758,2033,3910,0,4150,111387,1785,57114,4152
Sacramento,2/16/2021,8857,234615,4198,4659,0,5267,113076,3583,60697,5272
Sacramento,2/17/2021,8802,243417,4966,3836,0,5123,114534,3667,64364,5125
Sacramento,2/18/2021,8827,252244,5053,3774,0,5084,115886,3735,68099,5087
Sacramento,2/19/2021,9986,262230,6130,3856,0,5906,117730,4067,72166,5911
Sacramento,2/20/2021,7335,269565,5356,1979,0,4286,118975,3042,75208,4287
Sacramento,2/21/2021,2895,272460,2304,591,0,1010,118108,1877,77085,1010
Sacramento,2/22/2021,6161,278621,3731,2430,0,2668,117297,3483,80568,2672
Sacramento,2/23/2021,7117,285738,4426,2691,0,3462,117122,3640,84208,3465
Sacramento,2/24/2021,9590,295328,5281,4309,0,5252,118055,4324,88532,5257
Sacramento,2/25/2021,9995,305323,5388,4607,0,5525,119124,4456,92988,5525
Sacramento,2/26/2021,13862,319185,6449,7413,0,9539,124375,4292,97280,9543
Sacramento,2/27/2021,10778,329963,6702,4073,3,7927,129473,2833,100113,7931
Sacramento,2/28/2021,5569,335532,2203,3366,0,2563,129046,2991,103104,2564
Sacramento,3/1/2021,7955,343487,3424,4531,0,4277,129667,3658,106762,4279
Sacramento,3/2/2021,9201,352688,3996,5204,1,5638,131761,3548,110310,5642
Sacramento,3/3/2021,10739,363427,4917,5819,3,6354,133753,4367,114677,6359
Sacramento,3/4/2021,12301,375728,5098,7199,4,7084,135661,5187,119864,7095
Sacramento,3/5/2021,10509,386237,4867,5612,30,6979,139161,3510,123374,7010
Sacramento,3/6/2021,8050,394287,3089,4839,122,4071,139391,3962,127336,4192
Sacramento,3/7/2021,7553,401840,2185,5283,85,3705,139335,3844,131180,3788
Sacramento,3/8/2021,9065,410905,4223,4618,224,5931,142367,3121,134301,6153
Sacramento,3/9/2021,9463,420368,4513,4683,267,5431,144048,4017,138318,5698
Sacramento,3/10/2021,11601,431969,7461,3813,327,6776,146361,4792,143110,7105
Sacramento,3/11/2021,13821,445790,8867,4166,788,8198,149762,5584,148694,8985
Sacramento,3/12/2021,17204,462994,8289,8084,831,8112,149674,9040,157734,8952
Sacramento,3/13/2021,12911,475905,3564,8926,421,8137,153470,4761,162495,8557
Sacramento,3/14/2021,8353,484258,3449,4277,627,4472,154710,3858,166353,5098
Sacramento,3/15/2021,12116,496374,4805,6670,641,7058,157373,5037,171390,7700
Sacramento,3/16/2021,13919,510293,6185,7097,637,8605,161332,5280,176670,9239
Sacramento,3/17/2021,13509,523802,6546,6352,611,8700,165868,4780,181450,9316
Sacramento,3/18/2021,13968,537770,6574,6833,561,9258,171005,4680,186130,9817
Sacramento,3/19/2021,15008,552778,7446,6196,1366,7593,172572,7392,193522,8959
Sacramento,3/20/2021,12875,565653,7534,5002,339,8169,176404,4678,198200,8510
Sacramento,3/21/2021,5598,571251,2748,2811,39,4953,180765,633,198833,4994
Sacramento,3/22/2021,9215,580466,4759,3689,767,6228,184801,2961,201794,6997
Sacramento,3/23/2021,11262,591728,6710,3745,807,7284,188951,3941,205735,8091
Sacramento,3/24/2021,11785,603513,7238,3916,631,6806,191453,4937,210672,7439
Sacramento,3/25/2021,12474,615987,6807,4860,807,7242,194305,5195,215867,8047
Sacramento,3/26/2021,17511,633498,8283,8740,488,8576,194495,8876,224743,9066
Sacramento,3/27/2021,9557,643055,3543,5729,285,5132,195515,4395,229138,5415
Sacramento,3/28/2021,6467,649522,3211,3008,248,3104,195518,3354,232492,3357
Sacramento,3/29/2021,10787,660309,5873,4655,259,5153,195325,5608,238100,5415
Sacramento,3/30/2021,11648,671957,6042,5255,351,5965,195979,5661,243761,6315
Sacramento,3/31/2021,13197,685154,7798,5003,396,5649,194497,7523,251284,6041
Sacramento,4/1/2021,15360,700514,8660,6480,220,5752,190896,9580,260864,5979
Sacramento,4/2/2021,15919,716433,8660,6552,707,7927,191567,7966,268830,8637
Sacramento,4/3/2021,10339,726772,6162,3630,547,6355,194512,3955,272785,6900
Sacramento,4/4/2021,3635,730407,1508,1938,189,1423,193913,2208,274993,1609
Sacramento,4/5/2021,11962,742369,7509,3624,829,5344,193497,6585,281578,6169
Sacramento,4/6/2021,15448,757817,8795,5331,1322,6842,193085,8575,290153,8163
Sacramento,4/7/2021,14637,772454,7926,5139,1572,7116,194276,7489,297642,8680
Sacramento,4/8/2021,14844,787298,6683,5216,2945,5921,194241,8891,306533,8856
Sacramento,4/9/2021,15659,802957,7639,5863,2157,6092,192954,9530,316063,8243
Sacramento,4/10/2021,11507,814464,3102,7369,1036,4582,191663,6902,322965,5611
Sacramento,4/11/2021,9447,823911,3089,6138,220,2593,187643,6832,329797,2812
Sacramento,4/12/2021,12837,836748,4968,6022,1847,4920,186528,7870,337667,6755
Sacramento,4/13/2021,14199,850947,7902,6293,4,5585,183534,8587,346254,5593
Sacramento,4/14/2021,13957,864904,7118,6837,2,5052,179716,8876,355130,5058
Sacramento,4/15/2021,15003,879907,7420,7581,2,6243,177234,8730,363860,6248
Sacramento,4/16/2021,15756,895663,8115,7641,0,6996,175511,8721,372581,6998
Sacramento,4/17/2021,11221,906884,3746,7475,0,7544,179394,3664,376245,7547
Sacramento,4/18/2021,7199,914083,1907,5292,0,3426,179061,3760,380005,3427
Sacramento,4/19/2021,10303,924386,5635,4666,2,4630,178039,5656,385661,4634
Sacramento,4/20/2021,10954,935340,6640,4311,3,5854,178816,5084,390745,5861
Sacramento,4/21/2021,11210,946550,6522,4685,3,6060,179752,5128,395873,6064
Sacramento,4/22/2021,9825,956375,5943,3879,3,5166,180285,4638,400511,5171
Sacramento,4/23/2021,5665,962040,3633,2032,0,2824,180286,2823,403334,2824
San Benito,12/16/2020,2,2,2,0,0,2,2,0,0,2
San Benito,12/17/2020,8,10,8,0,0,8,10,0,0,8
San Benito,12/18/2020,32,42,32,0,0,32,42,0,0,32
San Benito,12/19/2020,47,89,47,0,0,47,89,0,0,47
San Benito,12/20/2020,22,111,21,1,0,22,111,0,0,22
San Benito,12/21/2020,48,159,48,0,0,48,159,0,0,48
San Benito,12/22/2020,65,224,65,0,0,65,224,0,0,65
San Benito,12/23/2020,48,272,36,12,0,48,272,0,0,48
San Benito,12/24/2020,12,284,4,8,0,12,284,0,0,12
San Benito,12/25/2020,4,288,4,0,0,4,288,0,0,4
San Benito,12/26/2020,13,301,4,9,0,13,301,0,0,13
San Benito,12/27/2020,8,309,7,1,0,8,309,0,0,8
San Benito,12/28/2020,63,372,36,27,0,63,372,0,0,63
San Benito,12/29/2020,49,421,20,29,0,49,421,0,0,49
San Benito,12/30/2020,59,480,37,22,0,59,480,0,0,59
San Benito,12/31/2020,19,499,2,17,0,19,499,0,0,19
San Benito,1/2/2021,24,523,23,1,0,24,523,0,0,24
San Benito,1/3/2021,3,526,1,2,0,3,526,0,0,3
San Benito,1/4/2021,62,588,23,39,0,62,588,0,0,62
San Benito,1/5/2021,118,706,36,82,0,115,700,3,3,115
San Benito,1/6/2021,97,803,42,55,0,83,769,14,17,83
San Benito,1/7/2021,80,883,43,37,0,52,793,28,45,52
San Benito,1/8/2021,129,1012,66,63,0,86,836,43,88,86
San Benito,1/9/2021,44,1056,31,13,0,30,852,14,102,30
San Benito,1/10/2021,15,1071,13,2,0,5,847,10,112,5
San Benito,1/11/2021,102,1173,59,43,0,49,843,53,165,49
San Benito,1/12/2021,156,1329,53,103,0,120,927,36,201,120
San Benito,1/13/2021,190,1519,35,155,0,163,1063,27,228,163
San Benito,1/14/2021,116,1635,23,93,0,99,1145,17,245,99
San Benito,1/15/2021,215,1850,21,194,0,201,1332,14,259,201
San Benito,1/16/2021,27,1877,9,18,0,21,1347,6,265,21
San Benito,1/17/2021,11,1888,5,6,0,8,1352,3,268,8
San Benito,1/18/2021,36,1924,23,13,0,21,1358,15,283,21
San Benito,1/19/2021,149,2073,63,86,0,123,1455,26,309,123
San Benito,1/20/2021,261,2334,80,181,0,215,1625,45,354,215
San Benito,1/21/2021,124,2458,31,93,0,100,1701,24,378,100
San Benito,1/22/2021,230,2688,19,211,0,220,1911,10,388,220
San Benito,1/23/2021,30,2718,16,14,0,13,1907,17,405,13
San Benito,1/24/2021,11,2729,3,8,0,7,1910,4,409,7
San Benito,1/25/2021,67,2796,25,42,0,22,1887,45,454,22
San Benito,1/26/2021,134,2930,41,93,0,81,1915,53,507,81
San Benito,1/27/2021,230,3160,69,161,0,190,2065,40,547,190
San Benito,1/28/2021,155,3315,32,123,0,123,2157,31,578,123
San Benito,1/29/2021,284,3599,31,253,0,261,2396,22,600,261
San Benito,1/30/2021,50,3649,31,19,0,28,2402,22,622,28
San Benito,1/31/2021,16,3665,5,11,0,11,2408,5,627,11
San Benito,2/1/2021,133,3798,28,105,0,89,2453,44,671,89
San Benito,2/2/2021,225,4023,49,176,0,135,2498,90,761,135
San Benito,2/3/2021,336,4359,42,294,0,272,2706,64,825,272
San Benito,2/4/2021,161,4520,24,137,0,117,2779,44,869,117
San Benito,2/5/2021,289,4809,40,249,0,227,2944,62,931,227
San Benito,2/6/2021,49,4858,9,40,0,32,2959,17,948,32
San Benito,2/7/2021,15,4873,7,8,0,14,2972,1,949,14
San Benito,2/8/2021,137,5010,15,122,0,91,3017,46,995,91
San Benito,2/9/2021,326,5336,64,262,0,195,3081,131,1126,195
San Benito,2/10/2021,318,5654,88,230,0,124,3011,194,1320,124
San Benito,2/11/2021,295,5949,31,264,0,197,3110,98,1418,197
San Benito,2/12/2021,412,6361,30,382,0,207,3113,204,1622,207
San Benito,2/13/2021,57,6418,8,49,0,43,3142,14,1636,43
San Benito,2/14/2021,40,6458,5,35,0,30,3162,10,1646,30
San Benito,2/15/2021,106,6564,9,97,0,95,3246,11,1657,95
San Benito,2/16/2021,204,6768,11,193,0,101,3244,103,1760,101
San Benito,2/17/2021,327,7095,30,297,0,278,3473,49,1809,278
San Benito,2/18/2021,291,7386,38,253,0,70,3322,221,2030,70
San Benito,2/19/2021,323,7709,45,278,0,158,3315,165,2195,158
San Benito,2/20/2021,45,7754,26,19,0,36,3342,9,2204,36
San Benito,2/21/2021,23,7777,8,15,0,14,3347,9,2213,14
San Benito,2/22/2021,132,7909,36,96,0,98,3412,33,2246,98
San Benito,2/23/2021,374,8283,92,282,0,262,3562,112,2358,262
San Benito,2/24/2021,375,8658,63,312,0,236,3659,139,2497,236
San Benito,2/25/2021,390,9048,63,327,0,270,3807,122,2619,270
San Benito,2/26/2021,641,9689,73,568,0,398,3962,243,2862,398
San Benito,2/27/2021,98,9787,36,62,0,83,4030,15,2877,83
San Benito,2/28/2021,248,10035,24,224,0,239,4260,9,2886,239
San Benito,3/1/2021,224,10259,59,165,0,155,4345,70,2956,155
San Benito,3/2/2021,274,10533,90,184,0,205,4481,69,3025,205
San Benito,3/3/2021,387,10920,55,332,0,213,4522,172,3197,213
San Benito,3/4/2021,608,11528,123,470,15,429,4776,179,3376,433
San Benito,3/5/2021,582,12110,305,264,13,373,4954,208,3584,386
San Benito,3/6/2021,189,12299,66,109,14,138,5055,51,3635,152
San Benito,3/7/2021,647,12946,603,22,22,615,5660,32,3667,637
San Benito,3/8/2021,288,13234,65,177,46,167,5752,121,3788,213
San Benito,3/9/2021,422,13656,84,239,99,136,5675,285,4073,208
San Benito,3/10/2021,400,14056,114,193,93,232,5832,168,4241,325
San Benito,3/11/2021,467,14523,119,196,152,207,5931,260,4501,359
San Benito,3/12/2021,511,15034,117,300,94,229,5975,280,4781,324
San Benito,3/13/2021,201,15235,102,81,18,128,6050,71,4852,146
San Benito,3/14/2021,232,15467,40,172,20,180,6199,51,4903,200
San Benito,3/15/2021,323,15790,99,205,19,189,6273,134,5037,208
San Benito,3/16/2021,494,16284,217,246,31,347,6503,147,5184,377
San Benito,3/17/2021,785,17069,475,288,22,558,6852,223,5407,572
San Benito,3/18/2021,786,17855,523,207,56,571,7257,213,5620,618
San Benito,3/19/2021,778,18633,404,351,23,595,7692,183,5803,618
San Benito,3/20/2021,234,18867,145,77,12,178,7826,56,5859,190
San Benito,3/21/2021,108,18975,56,47,5,81,7885,27,5886,86
San Benito,3/22/2021,343,19318,170,148,25,221,8009,122,6008,246
San Benito,3/23/2021,475,19793,197,268,10,215,7973,260,6268,224
San Benito,3/24/2021,573,20366,304,262,7,360,8128,212,6480,367
San Benito,3/25/2021,741,21107,440,297,4,445,8283,294,6774,449
San Benito,3/26/2021,995,22102,517,475,3,328,7948,666,7440,331
San Benito,3/27/2021,329,22431,182,114,33,212,8077,116,7556,245
San Benito,3/28/2021,691,23122,570,116,5,126,7643,565,8121,131
San Benito,3/29/2021,349,23471,113,216,20,154,7621,195,8316,173
San Benito,3/30/2021,570,24041,267,209,94,287,7719,283,8599,381
San Benito,3/31/2021,577,24618,354,199,24,330,7828,245,8844,354
San Benito,4/1/2021,930,25548,374,518,38,554,8039,375,9219,586
San Benito,4/2/2021,536,26084,261,140,135,264,8166,272,9491,399
San Benito,4/3/2021,249,26333,86,104,59,75,8126,174,9665,134
San Benito,4/4/2021,143,26476,108,30,5,106,8200,37,9702,111
San Benito,4/5/2021,351,26827,171,138,42,143,8176,208,9910,184
San Benito,4/6/2021,454,27281,158,121,175,159,8215,295,10205,334
San Benito,4/7/2021,922,28203,520,212,190,253,7990,668,10873,443
San Benito,4/8/2021,846,29049,423,171,252,214,7825,631,11504,466
San Benito,4/9/2021,856,29905,515,250,91,307,7674,549,12053,398
San Benito,4/10/2021,343,30248,214,71,58,197,7783,146,12199,255
San Benito,4/11/2021,503,30751,303,167,33,277,7866,226,12425,309
San Benito,4/12/2021,552,31303,312,129,111,302,8027,249,12674,410
San Benito,4/13/2021,781,32084,323,435,23,553,8377,227,12901,577
San Benito,4/14/2021,860,32944,683,177,0,426,8374,429,13330,426
San Benito,4/15/2021,917,33861,717,199,1,452,8363,464,13794,453
San Benito,4/16/2021,693,34554,362,322,9,290,8262,400,14194,299
San Benito,4/17/2021,304,34858,225,79,0,123,8204,181,14375,123
San Benito,4/18/2021,490,35348,409,81,0,239,8193,251,14626,240
San Benito,4/19/2021,716,36064,575,141,0,408,8295,307,14933,409
San Benito,4/20/2021,730,36794,384,345,1,466,8502,259,15192,466
San Benito,4/21/2021,854,37648,661,193,0,433,8528,407,15599,433
San Benito,4/22/2021,697,38345,568,129,0,457,8753,232,15831,457
San Benito,4/23/2021,163,38508,63,100,0,115,8820,48,15879,115
San Bernardino,12/15/2020,13,13,13,0,0,13,13,0,0,13
San Bernardino,12/16/2020,107,120,107,0,0,107,120,0,0,107
San Bernardino,12/17/2020,2349,2469,2349,0,0,2349,2469,0,0,2349
San Bernardino,12/18/2020,3141,5610,3138,3,0,3142,5611,0,0,3142
San Bernardino,12/19/2020,1068,6678,1067,1,0,1069,6680,0,0,1069
San Bernardino,12/20/2020,1174,7852,1172,2,0,1174,7854,0,0,1174
San Bernardino,12/21/2020,2452,10304,2447,5,0,2452,10306,0,0,2452
San Bernardino,12/22/2020,2266,12570,2140,126,0,2267,12573,0,0,2267
San Bernardino,12/23/2020,2646,15216,1454,1192,0,2645,15218,0,0,2645
San Bernardino,12/24/2020,1160,16376,585,575,0,1162,16380,0,0,1162
San Bernardino,12/25/2020,74,16450,14,60,0,74,16454,0,0,74
San Bernardino,12/26/2020,462,16912,254,208,0,462,16916,0,0,462
San Bernardino,12/27/2020,343,17255,160,183,0,343,17259,0,0,343
San Bernardino,12/28/2020,1564,18819,711,853,0,1565,18824,0,0,1565
San Bernardino,12/29/2020,2209,21028,1041,1168,0,2209,21033,0,0,2209
San Bernardino,12/30/2020,2891,23919,1459,1432,0,2892,23925,0,0,2892
San Bernardino,12/31/2020,1358,25277,440,918,0,1356,25281,0,0,1356
San Bernardino,1/1/2021,280,25557,150,130,0,279,25560,0,0,279
San Bernardino,1/2/2021,474,26031,338,136,0,474,26034,0,0,474
San Bernardino,1/3/2021,134,26165,85,49,0,134,26168,0,0,134
San Bernardino,1/4/2021,2119,28284,1286,833,0,2118,28286,0,0,2118
San Bernardino,1/5/2021,2329,30613,1458,871,0,2219,30396,109,109,2219
San Bernardino,1/6/2021,3427,34040,2353,1074,0,2934,32844,487,596,2935
San Bernardino,1/7/2021,5408,39448,4499,909,0,2478,32411,2911,3507,2478
San Bernardino,1/8/2021,5359,44807,4440,919,0,2286,31629,3069,6576,2287
San Bernardino,1/9/2021,1400,46207,1101,299,0,904,32037,496,7072,904
San Bernardino,1/10/2021,1018,47225,597,421,0,571,32161,447,7519,571
San Bernardino,1/11/2021,4979,52204,4075,904,0,2766,32717,2210,9729,2766
San Bernardino,1/12/2021,4227,56431,3218,1009,0,2514,33519,1712,11441,2514
San Bernardino,1/13/2021,4551,60982,2848,1703,0,3327,35636,1211,12652,3328
San Bernardino,1/14/2021,4742,65724,2773,1969,0,4159,39216,579,13231,4159
San Bernardino,1/15/2021,5976,71700,2973,3003,0,5581,44415,385,13616,5584
San Bernardino,1/16/2021,2257,73957,1292,965,0,2116,46390,141,13757,2116
San Bernardino,1/17/2021,1189,75146,515,674,0,1099,47402,89,13846,1101
San Bernardino,1/18/2021,4267,79413,2638,1629,0,3648,50435,618,14464,3651
San Bernardino,1/19/2021,6298,85711,3705,2593,0,5208,54557,1088,15552,5210
San Bernardino,1/20/2021,6799,92510,3731,3068,0,4871,57510,1920,17472,4873
San Bernardino,1/21/2021,5978,98488,3072,2906,0,4863,61269,1106,18578,4865
San Bernardino,1/22/2021,6500,104988,3035,3465,0,5779,66330,719,19297,5780
San Bernardino,1/23/2021,3103,108091,1889,1214,0,2716,68660,386,19683,2716
San Bernardino,1/24/2021,1194,109285,461,733,0,1094,69654,100,19783,1094
San Bernardino,1/25/2021,6862,116147,3396,3466,0,5017,72831,1843,21626,5020
San Bernardino,1/26/2021,7105,123252,3568,3537,0,5011,75748,2094,23720,5011
San Bernardino,1/27/2021,8396,131648,4149,4247,0,5692,78744,2696,26416,5692
San Bernardino,1/28/2021,8568,140216,4066,4502,0,6250,82681,2313,28729,6250
San Bernardino,1/29/2021,8174,148390,3765,4409,0,6209,86952,1952,30681,6223
San Bernardino,1/30/2021,3086,151476,1897,1189,0,2801,89469,284,30965,2801
San Bernardino,1/31/2021,922,152398,492,430,0,869,90286,52,31017,869
San Bernardino,2/1/2021,7533,159931,4229,3304,0,4916,92588,2614,33631,4916
San Bernardino,2/2/2021,10396,170327,3654,6742,0,8347,98891,2045,35676,8348
San Bernardino,2/3/2021,8971,179298,4144,4827,0,6485,102899,2478,38154,6486
San Bernardino,2/4/2021,10506,189804,5195,5311,0,7440,107284,3055,41209,7440
San Bernardino,2/5/2021,10973,200777,5909,5064,0,7454,111231,3508,44717,7455
San Bernardino,2/6/2021,5250,206027,2206,3044,0,3615,113239,1610,46327,3618
San Bernardino,2/7/2021,844,206871,491,353,0,467,113333,374,46701,468
San Bernardino,2/8/2021,7273,214144,3878,3395,0,5607,117278,1662,48363,5607
San Bernardino,2/9/2021,9908,224052,5821,4087,0,6682,120739,3224,51587,6685
San Bernardino,2/10/2021,12005,236057,6531,5474,0,7843,124432,4151,55738,7844
San Bernardino,2/11/2021,12322,248379,7105,5217,0,7884,127903,4416,60154,7887
San Bernardino,2/12/2021,10344,258723,5928,4416,0,5691,128955,4639,64793,5691
San Bernardino,2/13/2021,6012,264735,3996,2016,0,3775,130514,2221,67014,3780
San Bernardino,2/14/2021,1549,266284,649,900,0,872,130717,669,67683,872
San Bernardino,2/15/2021,5455,271739,2996,2459,0,3053,131382,2388,70071,3053
San Bernardino,2/16/2021,12591,284330,7373,5218,0,7967,134739,4611,74682,7968
San Bernardino,2/17/2021,11783,296113,6454,5329,0,7140,137254,4627,79309,7142
San Bernardino,2/18/2021,12448,308561,7584,4864,0,7709,140240,4724,84033,7710
San Bernardino,2/19/2021,11465,320026,5904,5561,0,6782,142358,4664,88697,6782
San Bernardino,2/20/2021,4493,324519,3450,1043,0,2040,141948,2451,91148,2041
San Bernardino,2/21/2021,1020,325539,563,457,0,323,141575,696,91844,323
San Bernardino,2/22/2021,8614,334153,5319,3295,0,4027,141027,4576,96420,4028
San Bernardino,2/23/2021,9066,343219,5402,3664,0,4555,141103,4479,100899,4555
San Bernardino,2/24/2021,12330,355549,7134,5196,0,6075,140948,6231,107130,6076
San Bernardino,2/25/2021,12981,368530,6261,6720,0,7552,143090,5413,112543,7555
San Bernardino,2/26/2021,13546,382076,6373,7173,0,7542,144691,5943,118486,7544
San Bernardino,2/27/2021,6605,388681,3672,2932,1,4785,147666,1811,120297,4786
San Bernardino,2/28/2021,1734,390415,710,1024,0,1121,148179,608,120905,1121
San Bernardino,3/1/2021,8373,398788,4314,4057,2,3815,147466,4537,125442,3824
San Bernardino,3/2/2021,13632,412420,5353,8279,0,6426,146716,7179,132621,6429
San Bernardino,3/3/2021,12523,424943,6358,6163,2,5751,145720,6754,139375,5758
San Bernardino,3/4/2021,13536,438479,6856,6680,0,5876,143960,7640,147015,5880
San Bernardino,3/5/2021,14119,452598,7300,6818,1,6832,143553,7258,154273,6851
San Bernardino,3/6/2021,9551,462149,5306,4030,215,4441,143112,5096,159369,4655
San Bernardino,3/7/2021,1568,463717,926,587,55,998,143597,568,159937,1053
San Bernardino,3/8/2021,7959,471676,3489,4310,160,3502,142811,4451,164388,3665
San Bernardino,3/9/2021,12579,484255,7017,5317,245,4846,140183,7720,172108,5092
San Bernardino,3/10/2021,13967,498222,7672,5773,522,6183,139136,7757,179865,6710
San Bernardino,3/11/2021,15145,513367,7107,6531,1507,7246,140007,7879,187744,8750
San Bernardino,3/12/2021,15212,528579,6784,6414,2014,7269,141422,7915,195659,9330
San Bernardino,3/13/2021,8265,536844,4494,3270,501,4903,143476,3352,199011,5406
San Bernardino,3/14/2021,3209,540053,1606,1035,568,1838,144511,1365,200376,2400
San Bernardino,3/15/2021,11266,551319,5311,3956,1999,5527,146303,5731,206107,7523
San Bernardino,3/16/2021,15995,567314,7904,7148,943,9755,150780,6218,212325,10695
San Bernardino,3/17/2021,16924,584238,8462,7714,748,10136,154893,6772,219097,10885
San Bernardino,3/18/2021,16262,600500,8064,7814,384,9552,158147,6683,225780,9937
San Bernardino,3/19/2021,16752,617252,8293,7872,587,9584,161228,7143,232923,10224
San Bernardino,3/20/2021,9382,626634,5906,2894,582,5576,163602,3781,236704,6155
San Bernardino,3/21/2021,2745,629379,2236,462,47,2224,165364,509,237213,2271
San Bernardino,3/22/2021,9540,638919,4483,4624,433,6927,170127,2598,239811,7361
San Bernardino,3/23/2021,15381,654300,8738,6022,621,9629,174642,5734,245545,10249
San Bernardino,3/24/2021,14923,669223,7755,6870,298,9951,179954,4938,250483,10250
San Bernardino,3/25/2021,16785,686008,8276,8216,293,10663,184828,6078,256561,10952
San Bernardino,3/26/2021,17843,703851,8578,8498,767,10840,189461,6974,263535,11607
San Bernardino,3/27/2021,10687,714538,6889,3051,747,6135,191806,4537,268072,6882
San Bernardino,3/28/2021,3517,718055,2469,936,112,2482,193371,1028,269100,2593
San Bernardino,3/29/2021,11573,729628,6069,5106,398,7893,197995,3667,272767,8291
San Bernardino,3/30/2021,16747,746375,9398,6640,709,10777,203539,5937,278704,11481
San Bernardino,3/31/2021,16145,762520,9137,6401,607,10882,209786,5239,283943,11486
San Bernardino,4/1/2021,19388,781908,10255,7781,1352,12557,216889,6802,290745,13905
San Bernardino,4/2/2021,18403,800311,9221,7914,1268,11128,222076,7249,297994,12436
San Bernardino,4/3/2021,10892,811203,6810,2960,1122,5967,224249,4913,302907,7086
San Bernardino,4/4/2021,2445,813648,1483,716,246,1256,224562,1187,304094,1500
San Bernardino,4/5/2021,11647,825295,5242,4681,1724,5988,226632,5639,309733,7709
San Bernardino,4/6/2021,19555,844850,10990,6477,2088,10388,229974,9133,318866,12475
San Bernardino,4/7/2021,20756,865606,11108,7201,2447,11377,234437,9351,328217,13814
San Bernardino,4/8/2021,21550,887156,11046,7920,2584,11940,239375,9581,337798,14519
San Bernardino,4/9/2021,21421,908577,10874,8021,2526,11680,243868,9708,347506,14201
San Bernardino,4/10/2021,15421,923998,7955,3791,3675,7671,247477,7729,355235,11338
San Bernardino,4/11/2021,4301,928299,2529,881,891,1998,248067,2298,357533,2888
San Bernardino,4/12/2021,13213,941512,6148,5458,1607,6262,249003,6931,364464,7867
San Bernardino,4/13/2021,19024,960536,10910,8096,18,10869,251759,8131,372595,10887
San Bernardino,4/14/2021,18740,979276,10233,8504,3,10710,254473,8000,380595,10714
San Bernardino,4/15/2021,19735,999011,11141,8591,3,10507,255794,9192,389787,10513
San Bernardino,4/16/2021,18232,1017243,10429,7801,2,9004,255609,9190,398977,9005
San Bernardino,4/17/2021,11722,1028965,7719,4003,0,6144,256204,5549,404526,6144
San Bernardino,4/18/2021,2747,1031712,1844,903,0,1252,255972,1484,406010,1252
San Bernardino,4/19/2021,12186,1043898,6478,5708,0,4661,253130,7507,413517,4665
San Bernardino,4/20/2021,17127,1061025,9583,7541,3,7800,251628,9306,422823,7804
San Bernardino,4/21/2021,17355,1078380,10157,7197,1,7619,249566,9682,432505,7620
San Bernardino,4/22/2021,15051,1093431,9255,5796,0,6322,247211,8679,441184,6324
San Bernardino,4/23/2021,9407,1102838,6425,2980,2,4093,246009,5299,446483,4097
San Diego,12/15/2020,119,119,119,0,0,119,119,0,0,119
San Diego,12/16/2020,1102,1221,1102,0,0,1102,1221,0,0,1102
San Diego,12/17/2020,2349,3570,2349,0,0,2349,3570,0,0,2349
San Diego,12/18/2020,3670,7240,3669,1,0,3670,7240,0,0,3670
San Diego,12/19/2020,2309,9549,2309,0,0,2309,9549,0,0,2309
San Diego,12/20/2020,1183,10732,1182,1,0,1183,10732,0,0,1183
San Diego,12/21/2020,3521,14253,3520,1,0,3521,14253,0,0,3521
San Diego,12/22/2020,4055,18308,3412,643,0,4055,18308,0,0,4055
San Diego,12/23/2020,3178,21486,1976,1202,0,3178,21486,0,0,3178
San Diego,12/24/2020,2735,24221,2219,516,0,2735,24221,0,0,2735
San Diego,12/25/2020,874,25095,873,1,0,874,25095,0,0,874
San Diego,12/26/2020,3294,28389,2143,1151,0,3294,28389,0,0,3294
San Diego,12/27/2020,2508,30897,1617,891,0,2507,30895,1,1,2507
San Diego,12/28/2020,5901,36798,4213,1688,0,5901,36796,0,1,5901
San Diego,12/29/2020,5589,42387,3014,2575,0,5589,42385,0,1,5589
San Diego,12/30/2020,5943,48330,3100,2843,0,5943,48328,0,1,5943
San Diego,12/31/2020,2984,51314,1004,1980,0,2984,51312,0,1,2984
San Diego,1/1/2021,1006,52320,452,554,0,1005,52317,0,1,1005
San Diego,1/2/2021,3762,56082,1321,2441,0,3762,56079,0,1,3762
San Diego,1/3/2021,859,56941,632,227,0,858,56937,0,1,858
San Diego,1/4/2021,3703,60644,2052,1651,0,3696,60633,0,1,3696
San Diego,1/5/2021,4310,64954,2122,2188,0,3693,63725,613,614,3705
San Diego,1/6/2021,4947,69901,2299,2648,0,3712,66229,1212,1826,3716
San Diego,1/7/2021,5608,75509,2981,2627,0,3452,67538,2149,3975,3458
San Diego,1/8/2021,7721,83230,4958,2763,0,3935,67720,3769,7744,3951
San Diego,1/9/2021,2956,86186,1554,1402,0,1788,68358,1158,8902,1796
San Diego,1/10/2021,1881,88067,1292,589,0,779,68056,1090,9992,788
San Diego,1/11/2021,10326,98393,5858,4468,0,6802,71355,3517,13509,6816
San Diego,1/12/2021,11204,109597,5316,5888,0,7831,75935,3364,16873,7944
San Diego,1/13/2021,11478,121075,5025,6453,0,8933,82359,2532,19405,8956
San Diego,1/14/2021,12366,133441,4752,7614,0,10199,90434,2158,21563,10233
San Diego,1/15/2021,15124,148565,5354,9770,0,12480,100341,2625,24188,12532
San Diego,1/16/2021,10767,159332,3594,7173,0,9320,108251,1442,25630,9352
San Diego,1/17/2021,8682,168014,2499,6183,0,7844,115275,838,26468,7862
San Diego,1/18/2021,12499,180513,5941,6558,0,9669,122207,2791,29259,9723
San Diego,1/19/2021,14751,195264,5823,8928,0,11625,130978,3112,32371,11883
San Diego,1/20/2021,18322,213586,6383,11939,0,15032,142910,3271,35642,15203
San Diego,1/21/2021,17403,230989,5898,11505,0,16011,157688,1381,37023,16159
San Diego,1/22/2021,17677,248666,4753,12924,0,15623,171367,2041,39064,15720
San Diego,1/23/2021,14478,263144,5271,9207,0,12117,181191,2348,41412,12172
San Diego,1/24/2021,11916,275060,3360,8556,0,10940,191192,974,42386,10975
San Diego,1/25/2021,12222,287282,5750,6472,0,9210,197548,3005,45391,9361
San Diego,1/26/2021,14944,302226,7646,7298,0,11669,206134,3270,48661,11856
San Diego,1/27/2021,20762,322988,8128,12634,0,17672,220870,3076,51737,17812
San Diego,1/28/2021,21303,344291,7646,13657,0,19041,237738,2252,53989,19120
San Diego,1/29/2021,19703,363994,6459,13244,0,17278,252647,2415,56404,17324
San Diego,1/30/2021,15899,379893,3667,12232,0,13219,263295,2670,59074,13318
San Diego,1/31/2021,14792,394685,5753,9039,0,14432,277400,356,59430,14461
San Diego,2/1/2021,20520,415205,7232,13288,0,17330,291631,3176,62606,17407
San Diego,2/2/2021,23198,438403,8689,14509,0,19668,307946,3520,66126,19835
San Diego,2/3/2021,27451,465854,11562,15889,0,23276,327245,4157,70283,23456
San Diego,2/4/2021,24379,490233,10029,14350,0,19677,342519,4685,74968,19959
San Diego,2/5/2021,25023,515256,8986,16037,0,18479,354967,6521,81489,18969
San Diego,2/6/2021,20792,536048,8569,12223,0,17596,369597,3190,84679,17820
San Diego,2/7/2021,12129,548177,5375,6754,0,10263,378267,1846,86525,10516
San Diego,2/8/2021,20103,568280,8519,11584,0,12688,384244,7399,93924,13376
San Diego,2/9/2021,20395,588675,8238,12157,0,13196,391329,7179,101103,14264
San Diego,2/10/2021,22984,611659,9359,13625,0,13885,397514,9055,110158,15240
San Diego,2/11/2021,23779,635438,10141,13638,0,12736,400907,11016,121174,14409
San Diego,2/12/2021,23843,659281,7459,16384,0,11920,403176,11905,133079,14174
San Diego,2/13/2021,20021,679302,9014,11007,0,10896,406150,9117,142196,12091
San Diego,2/14/2021,11187,690489,7431,3756,0,6335,409289,4848,147044,7987
San Diego,2/15/2021,15190,705679,7682,7508,0,7847,412949,7324,154368,10984
San Diego,2/16/2021,19281,724960,11251,8030,0,9233,415494,10037,164405,12582
San Diego,2/17/2021,23396,748356,10983,12413,0,8145,411968,15239,179644,11713
San Diego,2/18/2021,23573,771929,12021,11552,0,7790,408602,15775,195419,12409
San Diego,2/19/2021,15909,787838,10921,4988,0,6634,408080,9255,204674,8733
San Diego,2/20/2021,10259,798097,6361,3898,0,5818,411701,4437,209111,8058
San Diego,2/21/2021,11527,809624,10116,1411,0,5201,412898,6299,215410,7496
San Diego,2/22/2021,12445,822069,10584,1861,0,5804,414522,6634,222044,8258
San Diego,2/23/2021,25901,847970,14524,11377,0,9668,414884,16228,238272,16590
San Diego,2/24/2021,28952,876922,12762,16190,0,6869,408247,22065,260337,15428
San Diego,2/25/2021,33187,910109,14711,18476,0,10171,404793,22998,283335,19544
San Diego,2/26/2021,33457,943566,12393,21064,0,12147,402837,21283,304618,19327
San Diego,2/27/2021,21241,964807,9676,11565,0,11452,408955,9784,314402,15902
San Diego,2/28/2021,15244,980051,9944,5300,0,9498,416489,5745,320147,13279
San Diego,3/1/2021,24162,1004213,14239,9922,1,14674,426525,9414,329561,19450
San Diego,3/2/2021,26079,1030292,13995,12084,0,12725,433601,13347,342908,20423
San Diego,3/3/2021,33950,1064242,15881,18066,3,14055,435645,19880,362788,21924
San Diego,3/4/2021,28277,1092519,14065,14212,0,12647,440023,15610,378398,19988
San Diego,3/5/2021,28917,1121436,14820,14015,82,13491,445285,15411,393809,20673
San Diego,3/6/2021,23360,1144796,9523,13135,702,10298,448488,13048,406857,16251
San Diego,3/7/2021,18196,1162992,9294,8332,570,6911,449275,11278,418135,12065
San Diego,3/8/2021,23033,1186025,11164,10970,899,11430,454935,11592,429727,17252
San Diego,3/9/2021,25848,1211873,11940,12153,1755,10103,456691,15733,445460,17489
San Diego,3/10/2021,25257,1237130,10731,12133,2393,9875,459033,15371,460831,17713
San Diego,3/11/2021,28667,1265797,10996,14073,3598,10011,459177,18637,479468,18781
San Diego,3/12/2021,27063,1292860,9447,14482,3134,9959,458715,17090,496558,16628
San Diego,3/13/2021,25974,1318834,7298,17073,1603,10074,458689,15897,512455,15871
San Diego,3/14/2021,13704,1332538,5358,7610,736,4787,457731,8910,521365,7952
San Diego,3/15/2021,22006,1354544,10154,11074,778,9045,457734,12943,534308,12946
San Diego,3/16/2021,29890,1384434,15696,13781,413,15648,463290,14221,548529,19777
San Diego,3/17/2021,26234,1410668,12147,13378,709,16709,473691,9514,558043,19915
San Diego,3/18/2021,31372,1442040,17693,12784,895,16927,479713,14410,572453,20432
San Diego,3/19/2021,30158,1472198,14292,14889,977,19286,490855,10855,583308,21997
San Diego,3/20/2021,27777,1499975,8360,17626,1791,21359,509211,6409,589717,24765
San Diego,3/21/2021,16481,1516456,12005,3760,716,7684,511561,8785,598502,11135
San Diego,3/22/2021,22440,1538896,13094,9105,241,14292,521265,8138,606640,17842
San Diego,3/23/2021,25928,1564824,13604,12064,260,17136,532158,8776,615416,19669
San Diego,3/24/2021,29470,1594294,19700,9406,364,17077,540463,12384,627800,20689
San Diego,3/25/2021,30273,1624567,18197,11419,657,17981,548967,12277,640077,20781
San Diego,3/26/2021,32083,1656650,17862,13674,547,17572,555587,14481,654558,21101
San Diego,3/27/2021,25420,1682070,10976,14051,393,15702,564248,9702,664260,18363
San Diego,3/28/2021,14937,1697007,9170,5711,56,9202,569254,5728,669988,10734
San Diego,3/29/2021,26573,1723580,12843,13133,597,16398,578512,10166,680154,19424
San Diego,3/30/2021,33153,1756733,17867,14515,771,21999,591998,11136,691290,24622
San Diego,3/31/2021,30192,1786925,18722,10831,639,20551,604691,9622,700912,22315
San Diego,4/1/2021,34060,1820985,20112,12596,1352,23149,619645,10884,711796,25838
San Diego,4/2/2021,35470,1856455,20663,12254,2553,24153,636449,11300,723096,28104
San Diego,4/3/2021,30658,1887113,14422,11760,4476,19683,651086,10961,734057,25598
San Diego,4/4/2021,8900,1896013,5077,2924,899,4703,652754,4193,738250,5861
San Diego,4/5/2021,29591,1925604,15361,11681,2549,19386,667235,10193,748443,24674
San Diego,4/6/2021,38514,1964118,20358,12389,5767,22356,681907,16138,764581,30810
San Diego,4/7/2021,35463,1999581,21893,9148,4422,20313,693946,15125,779706,27164
San Diego,4/8/2021,34896,2034477,21254,9652,3990,21242,708166,13634,793340,27854
San Diego,4/9/2021,37930,2072407,22705,10229,4996,20724,720456,17136,810476,29426
San Diego,4/10/2021,28492,2100899,11699,12864,3929,14621,728359,13859,824335,21762
San Diego,4/11/2021,16101,2117000,9985,3855,2261,7228,732646,8870,833205,13157
San Diego,4/12/2021,30495,2147495,12773,13430,4292,17017,744137,13463,846668,24954
San Diego,4/13/2021,37044,2184539,17655,19355,34,24735,760336,12291,858959,28490
San Diego,4/14/2021,32744,2217283,18760,13973,11,17725,769125,15004,873963,23793
San Diego,4/15/2021,38778,2256061,20068,18708,2,23492,782022,15260,889223,28157
San Diego,4/16/2021,33076,2289137,18384,14691,1,19150,790204,13859,903082,22041
San Diego,4/17/2021,27541,2316678,13416,14125,0,12207,791012,15237,918319,16045
San Diego,4/18/2021,14163,2330841,8817,5343,3,6628,793731,7527,925846,10246
San Diego,4/19/2021,26111,2356952,13258,12852,1,12415,795472,13681,939527,15422
San Diego,4/20/2021,38020,2394972,16938,21082,0,19389,801829,18613,958140,24970
San Diego,4/21/2021,33803,2428775,19861,13942,0,16631,807304,17144,975284,22619
San Diego,4/22/2021,41359,2470134,20274,21080,5,20147,813504,21183,996467,27383
San Diego,4/23/2021,20043,2490177,13467,6565,11,7626,816810,12407,1008874,15713
San Francisco,12/15/2020,7,7,7,0,0,7,7,0,0,7
San Francisco,12/16/2020,229,236,229,0,0,229,236,0,0,229
San Francisco,12/17/2020,394,630,394,0,0,394,630,0,0,394
San Francisco,12/18/2020,877,1507,876,1,0,877,1507,0,0,877
San Francisco,12/19/2020,601,2108,601,0,0,601,2108,0,0,601
San Francisco,12/20/2020,483,2591,483,0,0,483,2591,0,0,483
San Francisco,12/21/2020,1162,3753,1162,0,0,1162,3753,0,0,1162
San Francisco,12/22/2020,1399,5152,1365,34,0,1399,5152,0,0,1399
San Francisco,12/23/2020,1332,6484,1042,290,0,1332,6484,0,0,1332
San Francisco,12/24/2020,840,7324,503,337,0,840,7324,0,0,840
San Francisco,12/25/2020,34,7358,29,5,0,34,7358,0,0,34
San Francisco,12/26/2020,245,7603,151,94,0,245,7603,0,0,245
San Francisco,12/27/2020,273,7876,60,213,0,273,7876,0,0,273
San Francisco,12/28/2020,1269,9145,685,584,0,1269,9145,0,0,1269
San Francisco,12/29/2020,1242,10387,621,621,0,1242,10387,0,0,1242
San Francisco,12/30/2020,1486,11873,780,706,0,1486,11873,0,0,1486
San Francisco,12/31/2020,962,12835,411,551,0,961,12834,0,0,961
San Francisco,1/1/2021,71,12906,61,10,0,71,12905,0,0,71
San Francisco,1/2/2021,333,13239,302,31,0,333,13238,0,0,333
San Francisco,1/3/2021,293,13532,101,192,0,292,13529,1,1,292
San Francisco,1/4/2021,1838,15370,1357,481,0,1835,15361,3,4,1835
San Francisco,1/5/2021,2233,17603,1415,818,0,2198,17526,35,39,2200
San Francisco,1/6/2021,1867,19470,1161,706,0,1602,18866,263,302,1603
San Francisco,1/7/2021,2059,21529,1202,857,0,1603,20016,453,755,1603
San Francisco,1/8/2021,2328,23857,1630,698,0,1492,20677,831,1586,1492
San Francisco,1/9/2021,1387,25244,892,495,0,883,21058,504,2090,885
San Francisco,1/10/2021,920,26164,542,378,0,460,21059,459,2549,460
San Francisco,1/11/2021,2501,28665,1870,631,0,1402,21361,1100,3649,1402
San Francisco,1/12/2021,3084,31749,2055,1029,0,1893,22064,1191,4840,1894
San Francisco,1/13/2021,2817,34566,1598,1219,0,1989,23225,828,5668,1989
San Francisco,1/14/2021,2435,37001,1097,1338,0,1875,24540,560,6228,1875
San Francisco,1/15/2021,2739,39740,1145,1594,0,2348,26501,389,6617,2350
San Francisco,1/16/2021,2249,41989,963,1286,0,2084,28421,165,6782,2085
San Francisco,1/17/2021,1918,43907,532,1386,0,1703,29909,215,6997,1703
San Francisco,1/18/2021,1371,45278,587,784,0,1109,30759,261,7258,1111
San Francisco,1/19/2021,2568,47846,1470,1098,0,1823,31837,745,8003,1823
San Francisco,1/20/2021,2703,50549,1084,1619,0,1955,33048,745,8748,1956
San Francisco,1/21/2021,3288,53837,926,2362,0,2469,34700,817,9565,2469
San Francisco,1/22/2021,3170,57007,633,2537,0,2728,36988,440,10005,2728
San Francisco,1/23/2021,3089,60096,608,2481,0,2722,39345,366,10371,2723
San Francisco,1/24/2021,2399,62495,336,2063,0,2172,41293,224,10595,2172
San Francisco,1/25/2021,4578,67073,1779,2799,0,3031,42780,1545,12140,3032
San Francisco,1/26/2021,4661,71734,2134,2527,0,3071,44266,1587,13727,3073
San Francisco,1/27/2021,4414,76148,2069,2345,0,3067,45990,1343,15070,3067
San Francisco,1/28/2021,3749,79897,1551,2198,0,2589,47424,1155,16225,2589
San Francisco,1/29/2021,4711,84608,1677,3034,0,3445,49610,1259,17484,3445
San Francisco,1/30/2021,3722,88330,1792,1930,0,3276,52444,445,17929,3279
San Francisco,1/31/2021,2348,90678,822,1526,0,2197,54492,150,18079,2198
San Francisco,2/1/2021,3778,94456,1518,2260,0,2879,56473,899,18978,2880
San Francisco,2/2/2021,4641,99097,1961,2680,0,2877,57592,1758,20736,2877
San Francisco,2/3/2021,5052,104149,2369,2683,0,3751,60046,1298,22034,3752
San Francisco,2/4/2021,5014,109163,2430,2584,0,3854,62742,1158,23192,3854
San Francisco,2/5/2021,5916,115079,3192,2724,0,4579,65988,1334,24526,4580
San Francisco,2/6/2021,5467,120546,3647,1820,0,4569,69662,896,25422,4570
San Francisco,2/7/2021,4320,124866,3170,1150,0,3744,72834,575,25997,3747
San Francisco,2/8/2021,6688,131554,4605,2083,0,5482,77129,1189,27186,5484
San Francisco,2/9/2021,5911,137465,3981,1930,0,4361,79944,1547,28733,4362
San Francisco,2/10/2021,6852,144317,4173,2679,0,5089,83281,1755,30488,5092
San Francisco,2/11/2021,6697,151014,3972,2725,0,4888,86364,1806,32294,4889
San Francisco,2/12/2021,5304,156318,2663,2641,0,3477,88015,1826,34120,3477
San Francisco,2/13/2021,4354,160672,2546,1808,0,3031,89725,1323,35443,3033
San Francisco,2/14/2021,3412,164084,2239,1173,0,2289,90893,1122,36565,2290
San Francisco,2/15/2021,2750,166834,1486,1264,0,1673,91491,1075,37640,1673
San Francisco,2/16/2021,4977,171811,2720,2257,0,2951,92429,2019,39659,2957
San Francisco,2/17/2021,5390,177201,2675,2715,0,2956,92961,2425,42084,2957
San Francisco,2/18/2021,5368,182569,2627,2741,0,2808,93212,2560,44644,2811
San Francisco,2/19/2021,5625,188194,2643,2982,0,2928,93451,2691,47335,2930
San Francisco,2/20/2021,4478,192672,2143,2335,0,1697,92376,2773,50108,1698
San Francisco,2/21/2021,2736,195408,1367,1369,0,1140,91925,1592,51700,1141
San Francisco,2/22/2021,5088,200496,3166,1922,0,2560,91967,2520,54220,2562
San Francisco,2/23/2021,5444,205940,3079,2365,0,2757,92043,2681,56901,2757
San Francisco,2/24/2021,8958,214898,5070,3888,0,4777,92649,4172,61073,4778
San Francisco,2/25/2021,9743,224641,6848,2895,0,6289,95488,3452,64525,6291
San Francisco,2/26/2021,11891,236532,7716,4175,0,7044,97684,4849,69374,7045
San Francisco,2/27/2021,8886,245418,5652,3233,1,4500,97813,4373,73747,4502
San Francisco,2/28/2021,7696,253114,5519,2177,0,3828,97775,3867,77614,3829
San Francisco,3/1/2021,10659,263773,7152,3505,2,5151,97440,5491,83105,5156
San Francisco,3/2/2021,8829,272602,5632,3197,0,5117,98854,3704,86809,5118
San Francisco,3/3/2021,10906,283508,6223,4682,1,5922,99807,4973,91782,5926
San Francisco,3/4/2021,8609,292117,5416,3193,0,4845,100894,3758,95540,4845
San Francisco,3/5/2021,8635,300752,5116,3516,3,5430,103132,3196,98736,5434
San Francisco,3/6/2021,6850,307602,4408,2235,207,4205,104884,2657,101393,4409
San Francisco,3/7/2021,5115,312717,3972,1087,56,2878,105567,2251,103644,2934
San Francisco,3/8/2021,7116,319833,5150,1780,186,5568,109741,1580,105224,5754
San Francisco,3/9/2021,6687,326520,3921,2392,374,4561,112539,2133,107357,4931
San Francisco,3/10/2021,10361,336881,5861,4006,494,6336,115364,4006,111363,6831
San Francisco,3/11/2021,10018,346899,6336,2723,959,6575,119464,3427,114790,7527
San Francisco,3/12/2021,10688,357587,6234,3147,1307,5937,121977,4728,119518,7241
San Francisco,3/13/2021,6566,364153,3834,1683,1049,4072,124610,2487,122005,5120
San Francisco,3/14/2021,7474,371627,4840,2398,236,4034,125452,3428,125433,4270
San Francisco,3/15/2021,11899,383526,9076,1890,933,8239,130970,3647,129080,9165
San Francisco,3/16/2021,12022,395548,8158,3407,457,8744,136905,3265,132345,9200
San Francisco,3/17/2021,13135,408683,8112,4482,541,9495,143323,3614,135959,10032
San Francisco,3/18/2021,9933,418616,6726,2586,621,5652,145337,4256,140215,6270
San Francisco,3/19/2021,11998,430614,8688,2848,462,6385,146592,5589,145804,6844
San Francisco,3/20/2021,8639,439253,6367,1813,459,5133,148708,3478,149282,5594
San Francisco,3/21/2021,6441,445694,5891,416,134,3681,149775,2748,152030,3815
San Francisco,3/22/2021,9639,455333,6791,2007,841,5071,151135,4548,156578,5908
San Francisco,3/23/2021,11111,466444,7340,3125,646,6696,154089,4385,160963,7339
San Francisco,3/24/2021,12230,478674,9376,2319,535,6327,155081,5867,166830,6859
San Francisco,3/25/2021,11754,490428,8629,2564,561,5889,155726,5801,172631,6446
San Francisco,3/26/2021,11823,502251,8177,3416,230,6108,156376,5685,178316,6335
San Francisco,3/27/2021,8596,510847,5735,2516,345,3903,155946,4677,182993,4247
San Francisco,3/28/2021,6563,517410,5235,1286,42,3161,155766,3380,186373,3200
San Francisco,3/29/2021,11350,528760,7855,3312,183,5134,154891,6191,192564,5316
San Francisco,3/30/2021,11478,540238,7168,4020,290,6882,157490,4572,197136,7171
San Francisco,3/31/2021,12080,552318,8017,3769,294,5625,156978,6426,203562,5914
San Francisco,4/1/2021,13642,565960,7255,4753,1634,5938,156871,7676,211238,7569
San Francisco,4/2/2021,14549,580509,6416,6326,1807,6863,157871,7667,218905,8667
San Francisco,4/3/2021,10224,590733,4756,3687,1781,4677,158791,5535,224440,6455
San Francisco,4/4/2021,8970,599703,4740,2578,1652,3596,158679,5362,229802,5250
San Francisco,4/5/2021,15872,615575,9723,4275,1874,6354,157409,9497,239299,8227
San Francisco,4/6/2021,15893,631468,9416,4429,2048,6242,156062,9632,248931,8285
San Francisco,4/7/2021,16559,648027,9958,4389,2212,6953,155626,9588,258519,9152
San Francisco,4/8/2021,14009,662036,6688,2952,4369,4617,155231,9365,267884,8970
San Francisco,4/9/2021,15623,677659,7582,4710,3331,6677,156308,8918,276802,9995
San Francisco,4/10/2021,12970,690629,5650,5710,1610,7054,159074,5892,282694,8658
San Francisco,4/11/2021,9952,700581,7451,1335,1166,5193,160683,4748,287442,6357
San Francisco,4/12/2021,10516,711097,6866,2524,1126,4861,161035,5632,293074,5984
San Francisco,4/13/2021,10617,721714,7259,3347,11,5398,161250,5197,298271,5412
San Francisco,4/14/2021,13198,734912,7979,5218,1,6439,160960,6730,305001,6440
San Francisco,4/15/2021,13477,748389,9391,4085,1,7960,163431,5494,310495,7965
San Francisco,4/16/2021,12743,761132,8620,4080,43,7579,165920,5138,315633,7627
San Francisco,4/17/2021,9763,770895,7226,2537,0,6898,169970,2851,318484,6901
San Francisco,4/18/2021,6530,777425,4985,1545,0,4054,171569,2457,320941,4056
San Francisco,4/19/2021,10680,788105,8018,2657,5,6885,174687,3782,324723,6900
San Francisco,4/20/2021,12192,800297,7096,5095,1,8434,179385,3739,328462,8437
San Francisco,4/21/2021,10366,810663,7436,2926,4,6344,181737,3999,332461,6351
San Francisco,4/22/2021,9551,820214,7058,2493,0,5576,183362,3957,336418,5582
San Francisco,4/23/2021,6001,826215,3366,2635,0,3621,184620,2365,338783,3623
San Joaquin,12/15/2020,12,12,12,0,0,12,12,0,0,12
San Joaquin,12/16/2020,305,317,305,0,0,305,317,0,0,305
San Joaquin,12/17/2020,311,628,311,0,0,311,628,0,0,311
San Joaquin,12/18/2020,519,1147,515,4,0,519,1147,0,0,519
San Joaquin,12/19/2020,189,1336,189,0,0,189,1336,0,0,189
San Joaquin,12/20/2020,112,1448,111,1,0,112,1448,0,0,112
San Joaquin,12/21/2020,517,1965,515,2,0,517,1965,0,0,517
San Joaquin,12/22/2020,961,2926,841,120,0,960,2925,0,0,960
San Joaquin,12/23/2020,956,3882,898,58,0,954,3879,0,0,954
San Joaquin,12/24/2020,214,4096,186,28,0,213,4092,0,0,213
San Joaquin,12/25/2020,14,4110,14,0,0,14,4106,0,0,14
San Joaquin,12/26/2020,101,4211,29,72,0,101,4207,0,0,101
San Joaquin,12/27/2020,41,4252,29,12,0,41,4248,0,0,41
San Joaquin,12/28/2020,618,4870,418,200,0,618,4866,0,0,618
San Joaquin,12/29/2020,794,5664,668,126,0,794,5660,0,0,794
San Joaquin,12/30/2020,1004,6668,713,291,0,1002,6662,0,0,1002
San Joaquin,12/31/2020,450,7118,201,249,0,451,7113,0,0,451
San Joaquin,1/1/2021,17,7135,10,7,0,17,7130,0,0,17
San Joaquin,1/2/2021,260,7395,238,22,0,260,7390,0,0,260
San Joaquin,1/3/2021,37,7432,19,18,0,36,7425,1,1,36
San Joaquin,1/4/2021,470,7902,335,135,0,468,7892,1,2,468
San Joaquin,1/5/2021,972,8874,643,329,0,805,8565,168,170,841
San Joaquin,1/6/2021,1211,10085,700,511,0,910,9181,297,467,913
San Joaquin,1/7/2021,1062,11147,666,396,0,776,9675,283,750,777
San Joaquin,1/8/2021,1191,12338,817,374,0,709,9906,482,1232,713
San Joaquin,1/9/2021,376,12714,300,76,0,247,10024,129,1361,247
San Joaquin,1/10/2021,222,12936,114,108,0,170,10142,52,1413,170
San Joaquin,1/11/2021,1503,14439,1301,202,0,854,10376,648,2061,882
San Joaquin,1/12/2021,1416,15855,1014,402,0,651,10336,761,2822,721
San Joaquin,1/13/2021,1459,17314,834,625,0,941,10765,517,3339,946
San Joaquin,1/14/2021,1640,18954,871,769,0,1305,11770,315,3654,1320
San Joaquin,1/15/2021,1587,20541,616,971,0,1375,12955,198,3852,1383
San Joaquin,1/16/2021,1133,21674,190,943,0,1106,14035,26,3878,1106
San Joaquin,1/17/2021,1608,23282,130,1478,0,1571,15571,37,3915,1573
San Joaquin,1/18/2021,734,24016,236,498,0,616,16073,114,4029,616
San Joaquin,1/19/2021,1845,25861,884,961,0,1168,16574,673,4702,1174
San Joaquin,1/20/2021,2069,27930,1276,793,0,1425,17364,640,5342,1430
San Joaquin,1/21/2021,1951,29881,881,1070,0,1561,18547,383,5725,1566
San Joaquin,1/22/2021,1949,31830,908,1041,0,1808,20220,138,5863,1811
San Joaquin,1/23/2021,887,32717,401,486,0,604,20545,282,6145,607
San Joaquin,1/24/2021,360,33077,156,204,0,340,20867,18,6163,340
San Joaquin,1/25/2021,1968,35045,1128,840,0,1412,21730,553,6716,1416
San Joaquin,1/26/2021,2136,37181,1108,1028,0,1533,22666,601,7317,1537
San Joaquin,1/27/2021,1713,38894,761,952,0,1227,23416,483,7800,1233
San Joaquin,1/28/2021,2008,40902,751,1257,0,1373,24159,633,8433,1376
San Joaquin,1/29/2021,2124,43026,1032,1092,0,1781,25609,338,8771,1788
San Joaquin,1/30/2021,2200,45226,395,1805,0,2025,27463,173,8944,2027
San Joaquin,1/31/2021,1554,46780,177,1377,0,1494,28902,56,9000,1495
San Joaquin,2/1/2021,2476,49256,1305,1171,0,1750,29930,725,9725,1753
San Joaquin,2/2/2021,2571,51827,1161,1410,0,1961,31344,551,10276,1965
San Joaquin,2/3/2021,3040,54867,1202,1838,0,2183,32679,852,11128,2187
San Joaquin,2/4/2021,3418,58285,1701,1717,0,2615,34499,797,11925,2617
San Joaquin,2/5/2021,3199,61484,1851,1348,0,2347,36003,846,12771,2350
San Joaquin,2/6/2021,1117,62601,786,331,0,943,36776,172,12943,945
San Joaquin,2/7/2021,612,63213,486,126,0,411,36994,194,13137,412
San Joaquin,2/8/2021,1764,64977,1030,734,0,1439,38132,304,13441,1442
San Joaquin,2/9/2021,2079,67056,1131,948,0,1554,39231,456,13897,1555
San Joaquin,2/10/2021,2544,69600,1251,1293,0,1332,39380,1183,15080,1332
San Joaquin,2/11/2021,2908,72508,1491,1417,0,1700,39906,1179,16259,1705
San Joaquin,2/12/2021,2785,75293,1116,1669,0,1577,40291,1196,17455,1581
San Joaquin,2/13/2021,2102,77395,395,1707,0,843,39891,1249,18704,849
San Joaquin,2/14/2021,1891,79286,259,1632,0,686,39395,1183,19887,687
San Joaquin,2/15/2021,1978,81264,846,1132,0,1195,39837,757,20644,1199
San Joaquin,2/16/2021,3134,84398,1366,1768,0,1742,40206,1380,22024,1749
San Joaquin,2/17/2021,3251,87649,1259,1992,0,1855,40681,1384,23408,1859
San Joaquin,2/18/2021,3304,90953,1360,1944,0,1888,41184,1392,24800,1895
San Joaquin,2/19/2021,4143,95096,2306,1837,0,2362,41799,1748,26548,2363
San Joaquin,2/20/2021,1563,96659,680,883,0,1058,42353,504,27052,1058
San Joaquin,2/21/2021,628,97287,475,153,0,398,42523,229,27281,399
San Joaquin,2/22/2021,3496,100783,2465,1031,0,2507,44076,959,28240,2512
San Joaquin,2/23/2021,4234,105017,2563,1671,0,2603,45075,1608,29848,2607
San Joaquin,2/24/2021,5648,110665,3358,2290,0,4075,47600,1554,31402,4079
San Joaquin,2/25/2021,6250,116915,3860,2390,0,4039,49467,2182,33584,4049
San Joaquin,2/26/2021,5384,122299,2828,2556,0,3716,51548,1643,35227,3724
San Joaquin,2/27/2021,5408,127707,1608,3800,0,2597,51393,2766,37993,2611
San Joaquin,2/28/2021,3033,130740,1088,1945,0,1993,52362,1027,39020,1996
San Joaquin,3/1/2021,4039,134779,1773,2266,0,2283,52913,1741,40761,2292
San Joaquin,3/2/2021,4063,138842,1649,2414,0,2521,53967,1525,42286,2579
San Joaquin,3/3/2021,5660,144502,3384,2274,2,4079,56486,1560,43846,4079
San Joaquin,3/4/2021,5624,150126,2227,3394,3,3679,58238,1935,45781,3687
San Joaquin,3/5/2021,4372,154498,1850,2520,2,3019,59921,1341,47122,3024
San Joaquin,3/6/2021,3269,157767,2161,979,129,2690,62166,577,47699,2822
San Joaquin,3/7/2021,1195,158962,549,601,45,917,62853,262,47961,949
San Joaquin,3/8/2021,3054,162016,1243,1687,124,2056,64043,989,48950,2179
San Joaquin,3/9/2021,3926,165942,1771,2029,126,2596,65452,1316,50266,2725
San Joaquin,3/10/2021,4603,170545,2441,2024,138,3393,67786,1197,51463,3531
San Joaquin,3/11/2021,4883,175428,2311,1978,594,2904,69320,1968,53431,3502
San Joaquin,3/12/2021,6202,181630,3099,2773,330,4131,71733,2053,55484,4466
San Joaquin,3/13/2021,3039,184669,1436,1476,127,2284,73404,747,56231,2418
San Joaquin,3/14/2021,2146,186815,667,1178,301,1036,73639,1107,57338,1342
San Joaquin,3/15/2021,6000,192815,3454,2146,400,3156,74383,2824,60162,3568
San Joaquin,3/16/2021,6743,199558,3828,2664,251,3988,75887,2744,62906,4248
San Joaquin,3/17/2021,7690,207248,4611,3009,70,4284,76870,3382,66288,4365
San Joaquin,3/18/2021,7558,214806,4444,2612,502,3738,77333,3784,70072,4247
San Joaquin,3/19/2021,7825,222631,4572,2710,543,4729,79573,3078,73150,5318
San Joaquin,3/20/2021,3633,226264,2102,1290,241,1815,79836,1805,74955,2068
San Joaquin,3/21/2021,2090,228354,1484,400,206,1187,80375,897,75852,1436
San Joaquin,3/22/2021,3920,232274,2003,1502,415,2327,81540,1582,77434,2747
San Joaquin,3/23/2021,5318,237592,2605,2548,165,3692,83791,1611,79045,3862
San Joaquin,3/24/2021,6749,244341,4184,2478,87,3007,83173,3720,82765,3102
San Joaquin,3/25/2021,5467,249808,3228,2198,41,3261,84296,2186,84951,3309
San Joaquin,3/26/2021,6072,255880,2501,3423,148,3202,84816,2849,87800,3369
San Joaquin,3/27/2021,4551,260431,2574,1935,42,1781,83900,2753,90553,1837
San Joaquin,3/28/2021,2669,263100,1768,876,25,1279,83921,1371,91924,1392
San Joaquin,3/29/2021,3959,267059,2122,1815,22,2004,84029,1945,93869,2053
San Joaquin,3/30/2021,6064,273123,3086,2919,59,3451,84972,2592,96461,3535
San Joaquin,3/31/2021,6472,279595,4064,2349,59,3318,85233,3143,99604,3404
San Joaquin,4/1/2021,6221,285816,2900,3242,79,2756,84679,3455,103059,2901
San Joaquin,4/2/2021,6221,292037,2825,2908,488,2467,83939,3735,106794,2995
San Joaquin,4/3/2021,4076,296113,2298,1454,324,1964,84141,2097,108891,2299
San Joaquin,4/4/2021,2227,298340,1316,709,202,1514,85161,705,109596,1725
San Joaquin,4/5/2021,4099,302439,2516,1417,166,2327,85905,1765,111361,2509
San Joaquin,4/6/2021,6903,309342,4424,2222,257,3283,85857,3600,114961,3552
San Joaquin,4/7/2021,8167,317509,4407,2193,1567,3401,86086,4755,119716,4984
San Joaquin,4/8/2021,8556,326065,4620,1932,2004,3267,86091,5271,124987,5276
San Joaquin,4/9/2021,8371,334436,3866,2962,1543,3024,85351,5327,130314,4587
San Joaquin,4/10/2021,5106,339542,1599,1620,1887,1697,85528,3406,133720,3583
San Joaquin,4/11/2021,3971,343513,1524,1292,1155,1684,86089,2274,135994,2835
San Joaquin,4/12/2021,5381,348894,2145,2027,1209,2097,86132,3269,139263,3312
San Joaquin,4/13/2021,7272,356166,4201,3068,3,4428,87744,2827,142090,4439
San Joaquin,4/14/2021,6973,363139,3449,3524,0,4093,88982,2863,144953,4101
San Joaquin,4/15/2021,7095,370234,4004,3091,0,3844,89611,3220,148173,3849
San Joaquin,4/16/2021,6227,376461,2934,3290,3,3833,91086,2370,150543,3845
San Joaquin,4/17/2021,4531,380992,2215,2316,0,3240,93060,1283,151826,3257
San Joaquin,4/18/2021,2368,383360,1285,1083,0,1266,93245,1088,152914,1273
San Joaquin,4/19/2021,4731,388091,2414,2317,0,2427,93398,2285,155199,2438
San Joaquin,4/20/2021,5710,393801,2816,2894,0,2843,93406,2846,158045,2854
San Joaquin,4/21/2021,4969,398770,2535,2433,1,2810,94109,2113,160158,2816
San Joaquin,4/22/2021,4647,403417,2802,1845,0,2705,94905,1918,162076,2714
San Joaquin,4/23/2021,3227,406644,1612,1615,0,2136,95961,1082,163158,2138
San Luis Obispo,12/16/2020,4,4,4,0,0,4,4,0,0,4
San Luis Obispo,12/17/2020,196,200,196,0,0,196,200,0,0,196
San Luis Obispo,12/18/2020,224,424,224,0,0,224,424,0,0,224
San Luis Obispo,12/19/2020,162,586,162,0,0,162,586,0,0,162
San Luis Obispo,12/20/2020,215,801,215,0,0,215,801,0,0,215
San Luis Obispo,12/21/2020,549,1350,549,0,0,549,1350,0,0,549
San Luis Obispo,12/22/2020,307,1657,303,4,0,307,1657,0,0,307
San Luis Obispo,12/23/2020,680,2337,367,313,0,680,2337,0,0,680
San Luis Obispo,12/24/2020,194,2531,19,175,0,194,2531,0,0,194
San Luis Obispo,12/25/2020,2,2533,1,1,0,2,2533,0,0,2
San Luis Obispo,12/26/2020,90,2623,12,78,0,90,2623,0,0,90
San Luis Obispo,12/27/2020,76,2699,0,76,0,76,2699,0,0,76
San Luis Obispo,12/28/2020,879,3578,430,449,0,879,3578,0,0,879
San Luis Obispo,12/29/2020,903,4481,502,401,0,903,4481,0,0,903
San Luis Obispo,12/30/2020,1174,5655,681,493,0,1174,5655,0,0,1174
San Luis Obispo,12/31/2020,106,5761,4,102,0,106,5761,0,0,106
San Luis Obispo,1/1/2021,13,5774,8,5,0,13,5774,0,0,13
San Luis Obispo,1/2/2021,33,5807,8,25,0,33,5807,0,0,33
San Luis Obispo,1/3/2021,16,5823,6,10,0,16,5823,0,0,16
San Luis Obispo,1/4/2021,676,6499,524,152,0,676,6499,0,0,676
San Luis Obispo,1/5/2021,974,7473,756,218,0,972,7469,2,2,972
San Luis Obispo,1/6/2021,724,8197,480,244,0,716,8178,7,9,716
San Luis Obispo,1/7/2021,1127,9324,949,178,0,685,8421,442,451,685
San Luis Obispo,1/8/2021,881,10205,804,77,0,512,8565,368,819,512
San Luis Obispo,1/9/2021,205,10410,196,9,0,28,8416,177,996,28
San Luis Obispo,1/10/2021,12,10422,8,4,0,8,8420,4,1000,8
San Luis Obispo,1/11/2021,526,10948,475,51,0,265,8425,260,1260,265
San Luis Obispo,1/12/2021,597,11545,379,218,0,320,8468,277,1537,320
San Luis Obispo,1/13/2021,882,12427,254,628,0,644,8876,236,1773,644
San Luis Obispo,1/14/2021,730,13157,244,486,0,605,9369,112,1885,605
San Luis Obispo,1/15/2021,729,13886,287,442,0,554,9753,170,2055,554
San Luis Obispo,1/16/2021,99,13985,81,18,0,94,9842,5,2060,94
San Luis Obispo,1/17/2021,67,14052,61,6,0,67,9909,0,2060,67
San Luis Obispo,1/18/2021,1372,15424,389,983,0,1110,10757,262,2322,1110
San Luis Obispo,1/19/2021,1585,17009,418,1167,0,1177,11526,408,2730,1177
San Luis Obispo,1/20/2021,1883,18892,596,1287,0,1293,12232,588,3318,1294
San Luis Obispo,1/21/2021,1570,20462,466,1104,0,1197,13061,369,3687,1198
San Luis Obispo,1/22/2021,1521,21983,508,1013,0,1206,13954,313,4000,1206
San Luis Obispo,1/23/2021,311,22294,293,18,0,295,14233,16,4016,295
San Luis Obispo,1/24/2021,245,22539,238,7,0,239,14466,6,4022,239
San Luis Obispo,1/25/2021,2071,24610,606,1465,0,1243,14881,828,4850,1243
San Luis Obispo,1/26/2021,2003,26613,703,1300,0,1136,15150,867,5717,1136
San Luis Obispo,1/27/2021,1612,28225,283,1329,0,1151,15840,461,6178,1151
San Luis Obispo,1/28/2021,1484,29709,342,1142,0,1224,16805,259,6437,1224
San Luis Obispo,1/29/2021,1734,31443,681,1053,0,1450,17971,284,6721,1450
San Luis Obispo,1/30/2021,37,31480,18,19,0,26,17987,10,6731,26
San Luis Obispo,1/31/2021,26,31506,20,6,0,23,18007,3,6734,23
San Luis Obispo,2/1/2021,1664,33170,703,961,0,1395,19134,268,7002,1395
San Luis Obispo,2/2/2021,1895,35065,676,1219,0,1521,20281,374,7376,1521
San Luis Obispo,2/3/2021,1701,36766,727,974,0,1289,21158,412,7788,1289
San Luis Obispo,2/4/2021,1656,38422,800,856,0,1089,21680,567,8355,1089
San Luis Obispo,2/5/2021,1604,40026,717,887,0,1060,22196,545,8900,1061
San Luis Obispo,2/6/2021,159,40185,92,67,0,93,22223,66,8966,93
San Luis Obispo,2/7/2021,144,40329,99,45,0,74,22228,70,9036,75
San Luis Obispo,2/8/2021,853,41182,468,385,0,495,22366,357,9393,495
San Luis Obispo,2/9/2021,1122,42304,448,674,0,541,22339,575,9968,548
San Luis Obispo,2/10/2021,1428,43732,486,942,0,521,21959,904,10872,524
San Luis Obispo,2/11/2021,1330,45062,844,486,0,655,21942,672,11544,655
San Luis Obispo,2/12/2021,787,45849,363,424,0,417,21989,370,11914,417
San Luis Obispo,2/13/2021,390,46239,124,266,0,284,22168,105,12019,284
San Luis Obispo,2/14/2021,317,46556,42,275,0,280,22412,37,12056,281
San Luis Obispo,2/15/2021,723,47279,137,586,0,467,22626,253,12309,467
San Luis Obispo,2/16/2021,2960,50239,1194,1766,0,1358,22388,1596,13905,1358
San Luis Obispo,2/17/2021,2773,53012,1237,1536,0,1029,21682,1735,15640,1029
San Luis Obispo,2/18/2021,2808,55820,1444,1364,0,1119,21121,1681,17321,1120
San Luis Obispo,2/19/2021,1452,57272,1332,120,0,1129,21928,322,17643,1129
San Luis Obispo,2/20/2021,249,57521,79,170,0,213,22105,36,17679,213
San Luis Obispo,2/21/2021,48,57569,45,3,0,29,22115,19,17698,29
San Luis Obispo,2/22/2021,2400,59969,1856,544,0,1460,22636,940,18638,1461
San Luis Obispo,2/23/2021,1856,61825,1740,116,0,1365,23511,490,19128,1365
San Luis Obispo,2/24/2021,2643,64468,1300,1343,0,835,22540,1806,20934,835
San Luis Obispo,2/25/2021,2130,66598,1243,887,0,1206,22830,917,21851,1207
San Luis Obispo,2/26/2021,2642,69240,1148,1494,0,1324,22842,1312,23163,1324
San Luis Obispo,2/27/2021,566,69806,340,226,0,520,23316,46,23209,520
San Luis Obispo,2/28/2021,196,70002,72,124,0,163,23450,29,23238,163
San Luis Obispo,3/1/2021,2955,72957,1842,1112,1,2033,24563,922,24160,2035
San Luis Obispo,3/2/2021,2985,75942,1886,1099,0,1840,25263,1141,25301,1841
San Luis Obispo,3/3/2021,2267,78209,328,1939,0,822,24647,1439,26740,823
San Luis Obispo,3/4/2021,2174,80383,1147,1027,0,1166,24809,1006,27746,1168
San Luis Obispo,3/5/2021,2292,82675,1017,1205,70,1287,25176,990,28736,1357
San Luis Obispo,3/6/2021,830,83505,308,415,107,611,25669,219,28955,712
San Luis Obispo,3/7/2021,199,83704,32,83,84,70,25696,128,29083,155
San Luis Obispo,3/8/2021,2722,86426,752,1656,314,1540,26369,1180,30263,1853
San Luis Obispo,3/9/2021,2914,89340,956,1722,236,1512,26719,1399,31662,1749
San Luis Obispo,3/10/2021,3174,92514,1240,1664,270,1811,27440,1360,33022,2081
San Luis Obispo,3/11/2021,3085,95599,1270,1513,302,1692,28049,1384,34406,1993
San Luis Obispo,3/12/2021,3160,98759,1281,1540,339,1552,28343,1600,36006,1894
San Luis Obispo,3/13/2021,788,99547,259,420,109,428,28519,360,36366,536
San Luis Obispo,3/14/2021,513,100060,54,348,111,135,28388,377,36743,246
San Luis Obispo,3/15/2021,3046,103106,1096,1852,98,1527,28497,1516,38259,1625
San Luis Obispo,3/16/2021,2844,105950,1510,1234,100,1448,28654,1390,39649,1547
San Luis Obispo,3/17/2021,3422,109372,1448,1712,262,1979,29458,1436,41085,2240
San Luis Obispo,3/18/2021,2782,112154,1445,1144,193,1333,29538,1446,42531,1526
San Luis Obispo,3/19/2021,2582,114736,1563,697,322,960,29205,1617,44148,1284
San Luis Obispo,3/20/2021,824,115560,492,296,36,378,29173,446,44594,414
San Luis Obispo,3/21/2021,186,115746,45,138,3,157,29304,29,44623,160
San Luis Obispo,3/22/2021,2678,118424,1170,1461,47,1862,30401,812,45435,1909
San Luis Obispo,3/23/2021,3356,121780,2212,1126,18,2263,31593,1089,46524,2281
San Luis Obispo,3/24/2021,3477,125257,2127,1280,70,2616,33421,857,47381,2685
San Luis Obispo,3/25/2021,3656,128913,2282,1362,12,2633,35045,1020,48401,2644
San Luis Obispo,3/26/2021,3132,132045,1758,953,421,1752,35843,1375,49776,2173
San Luis Obispo,3/27/2021,990,133035,506,388,96,446,35843,542,50318,542
San Luis Obispo,3/28/2021,441,133476,151,234,56,240,35938,201,50519,296
San Luis Obispo,3/29/2021,2574,136050,1271,1169,134,1656,36822,906,51425,1790
San Luis Obispo,3/30/2021,3494,139544,1904,1447,143,2343,38160,1146,52571,2484
San Luis Obispo,3/31/2021,3807,143351,2444,1216,147,2445,39399,1353,53924,2592
San Luis Obispo,4/1/2021,3796,147147,2419,1283,94,2683,41071,1104,55028,2776
San Luis Obispo,4/2/2021,1714,148861,682,721,311,918,41504,795,55823,1228
San Luis Obispo,4/3/2021,1087,149948,552,408,127,472,41493,610,56433,599
San Luis Obispo,4/4/2021,378,150326,130,208,40,231,41617,147,56580,271
San Luis Obispo,4/5/2021,3591,153917,1945,1536,110,2048,42232,1541,58121,2156
San Luis Obispo,4/6/2021,3989,157906,2136,1544,309,1937,42432,2046,60167,2246
San Luis Obispo,4/7/2021,4249,162155,2333,1576,340,2467,43468,1769,61936,2805
San Luis Obispo,4/8/2021,3988,166143,2187,1411,390,2172,44221,1809,63745,2562
San Luis Obispo,4/9/2021,3595,169738,1709,1145,741,1534,44441,2052,65797,2272
San Luis Obispo,4/10/2021,1559,171297,555,343,661,480,44502,1078,66875,1139
San Luis Obispo,4/11/2021,312,171609,63,186,63,125,44505,185,67060,188
San Luis Obispo,4/12/2021,3345,174954,1693,1489,163,1391,44105,1954,69014,1554
San Luis Obispo,4/13/2021,3623,178577,2094,1528,1,1957,44400,1664,70678,1959
San Luis Obispo,4/14/2021,2813,181390,1675,1135,3,1654,44908,1148,71826,1656
San Luis Obispo,4/15/2021,3601,184991,2362,1238,1,1925,45175,1659,73485,1926
San Luis Obispo,4/16/2021,3567,188558,2188,1376,3,1789,45191,1775,75260,1791
San Luis Obispo,4/17/2021,1083,189641,431,650,2,715,45541,367,75627,717
San Luis Obispo,4/18/2021,317,189958,96,220,1,108,45443,207,75834,109
San Luis Obispo,4/19/2021,2945,192903,1283,1626,36,1119,44775,1824,77658,1156
San Luis Obispo,4/20/2021,3428,196331,1890,1538,0,1356,44070,2061,79719,1356
San Luis Obispo,4/21/2021,3004,199335,1241,1763,0,1360,43796,1634,81353,1360
San Luis Obispo,4/22/2021,2131,201466,941,1190,0,801,43276,1323,82676,803
San Luis Obispo,4/23/2021,245,201711,99,142,4,118,43279,127,82803,130
San Mateo,12/15/2020,26,26,26,0,0,26,26,0,0,26
San Mateo,12/16/2020,110,136,110,0,0,110,136,0,0,110
San Mateo,12/17/2020,162,298,162,0,0,162,298,0,0,162
San Mateo,12/18/2020,740,1038,738,2,0,740,1038,0,0,740
San Mateo,12/19/2020,509,1547,509,0,0,509,1547,0,0,509
San Mateo,12/20/2020,508,2055,507,1,0,508,2055,0,0,508
San Mateo,12/21/2020,1153,3208,1153,0,0,1153,3208,0,0,1153
San Mateo,12/22/2020,1513,4721,1506,7,0,1513,4721,0,0,1513
San Mateo,12/23/2020,1570,6291,1384,186,0,1570,6291,0,0,1570
San Mateo,12/24/2020,866,7157,609,257,0,866,7157,0,0,866
San Mateo,12/25/2020,114,7271,110,4,0,114,7271,0,0,114
San Mateo,12/26/2020,560,7831,417,143,0,560,7831,0,0,560
San Mateo,12/27/2020,305,8136,175,130,0,305,8136,0,0,305
San Mateo,12/28/2020,1048,9184,702,346,0,1048,9184,0,0,1048
San Mateo,12/29/2020,1128,10312,705,423,0,1128,10312,0,0,1128
San Mateo,12/30/2020,1263,11575,760,503,0,1263,11575,0,0,1263
San Mateo,12/31/2020,717,12292,232,485,0,716,12290,1,1,716
San Mateo,1/1/2021,41,12333,32,9,0,41,12331,0,1,41
San Mateo,1/2/2021,398,12731,269,129,0,398,12729,0,1,398
San Mateo,1/3/2021,281,13012,206,75,0,278,13004,3,4,278
San Mateo,1/4/2021,1056,14068,682,374,0,1056,14060,0,4,1056
San Mateo,1/5/2021,1199,15267,705,494,0,1170,15202,29,33,1171
San Mateo,1/6/2021,1447,16714,950,497,0,1267,16292,178,211,1268
San Mateo,1/7/2021,1450,18164,804,646,0,1162,17174,281,492,1163
San Mateo,1/8/2021,1837,20001,1190,647,0,1140,17625,690,1182,1141
San Mateo,1/9/2021,1179,21180,775,404,0,723,17892,456,1638,723
San Mateo,1/10/2021,699,21879,570,129,0,265,17723,434,2072,265
San Mateo,1/11/2021,2586,24465,1480,1106,0,1524,18185,1063,3135,1525
San Mateo,1/12/2021,3280,27745,1770,1510,0,2100,19110,1178,4313,2103
San Mateo,1/13/2021,3471,31216,1748,1723,0,2439,20520,1032,5345,2442
San Mateo,1/14/2021,3775,34991,1582,2193,0,3091,22932,684,6029,3096
San Mateo,1/15/2021,4332,39323,1710,2622,0,3804,26212,526,6555,3806
San Mateo,1/16/2021,3084,42407,776,2308,0,2765,28658,319,6874,2765
San Mateo,1/17/2021,1309,43716,308,1001,0,1101,29551,208,7082,1101
San Mateo,1/18/2021,1363,45079,531,832,0,989,30173,371,7453,993
San Mateo,1/19/2021,2793,47872,1781,1012,0,2003,31389,787,8240,2003
San Mateo,1/20/2021,2654,50526,1401,1253,0,1809,32357,842,9082,1810
San Mateo,1/21/2021,2823,53349,1280,1543,0,2243,34024,579,9661,2246
San Mateo,1/22/2021,2788,56137,1130,1658,0,2489,36217,297,9958,2490
San Mateo,1/23/2021,2881,59018,1688,1193,0,2518,38373,363,10321,2519
San Mateo,1/24/2021,1518,60536,373,1145,0,1210,39276,307,10628,1210
San Mateo,1/25/2021,4428,64964,3146,1282,0,3533,41918,893,11521,3535
San Mateo,1/26/2021,4294,69258,2982,1312,0,3392,44409,901,12422,3392
San Mateo,1/27/2021,2778,72036,1462,1316,0,1785,45208,987,13409,1786
San Mateo,1/28/2021,2794,74830,1348,1446,0,1948,46325,831,14240,1948
San Mateo,1/29/2021,2971,77801,1331,1640,0,2139,47638,829,15069,2142
San Mateo,1/30/2021,3374,81175,1473,1901,0,2917,50100,456,15525,2918
San Mateo,1/31/2021,1681,82856,897,784,0,1519,51459,160,15685,1519
San Mateo,2/1/2021,2921,85777,1343,1578,0,2213,52969,704,16389,2214
San Mateo,2/2/2021,3167,88944,1726,1441,0,2154,54113,1010,17399,2154
San Mateo,2/3/2021,4875,93819,1944,2931,0,3823,56888,1049,18448,3824
San Mateo,2/4/2021,6282,100101,2586,3696,0,4923,60461,1353,19801,4926
San Mateo,2/5/2021,6786,106887,2551,4235,0,4961,63614,1808,21609,4961
San Mateo,2/6/2021,3282,110169,1917,1365,0,2618,65571,663,22272,2620
San Mateo,2/7/2021,1898,112067,1343,555,0,1711,67095,187,22459,1711
San Mateo,2/8/2021,5273,117340,2244,3029,0,3101,68088,2108,24567,3101
San Mateo,2/9/2021,6174,123514,3216,2958,0,3333,68584,2837,27404,3333
San Mateo,2/10/2021,6496,130010,3270,3226,0,3542,69181,2945,30349,3542
San Mateo,2/11/2021,7043,137053,3577,3466,0,3815,69781,3218,33567,3818
San Mateo,2/12/2021,6618,143671,2952,3666,0,4705,72579,1909,35476,4707
San Mateo,2/13/2021,6089,149760,3992,2097,0,2639,71772,3446,38922,2639
San Mateo,2/14/2021,4625,154385,3014,1611,0,1977,71105,2645,41567,1978
San Mateo,2/15/2021,3164,157549,1458,1706,0,1787,71520,1373,42940,1788
San Mateo,2/16/2021,7143,164692,1871,5272,0,5280,74940,1862,44802,5282
San Mateo,2/17/2021,7049,171741,1932,5117,0,5065,78028,1979,46781,5067
San Mateo,2/18/2021,6677,178418,4620,2057,0,4438,80233,2235,49016,4440
San Mateo,2/19/2021,7807,186225,5609,2198,0,5821,84074,1980,50996,5821
San Mateo,2/20/2021,3728,189953,2412,1316,0,2304,84961,1417,52413,2304
San Mateo,2/21/2021,2302,192255,1461,841,0,1257,85177,1041,53454,1257
San Mateo,2/22/2021,4412,196667,3190,1222,0,2780,86331,1626,55080,2780
San Mateo,2/23/2021,4285,200952,3041,1244,0,2480,87012,1799,56879,2480
San Mateo,2/24/2021,7264,208216,3247,4017,0,4844,89441,2415,59294,4844
San Mateo,2/25/2021,9070,217286,4001,5069,0,6006,92398,3049,62343,6006
San Mateo,2/26/2021,9741,227027,3704,6037,0,6826,96324,2902,65245,6828
San Mateo,2/27/2021,6677,233704,3411,3265,1,3629,96917,3043,68288,3636
San Mateo,2/28/2021,4121,237825,2503,1618,0,2552,97905,1565,69853,2553
San Mateo,3/1/2021,5618,243443,3510,2108,0,2777,97850,2832,72685,2777
San Mateo,3/2/2021,5763,249206,3963,1799,1,3317,98731,2438,75123,3319
San Mateo,3/3/2021,8265,257471,3848,4416,1,3566,97609,4689,79812,3567
San Mateo,3/4/2021,8363,265834,3921,4440,2,3789,96843,4559,84371,3793
San Mateo,3/5/2021,9062,274896,5971,3088,3,6404,100616,2638,87009,6411
San Mateo,3/6/2021,7829,282725,5426,2227,176,5725,104421,2095,89104,5900
San Mateo,3/7/2021,3463,286188,2311,1085,67,2004,105037,1455,90559,2071
San Mateo,3/8/2021,4415,290603,2462,1737,216,3200,107245,1209,91768,3417
San Mateo,3/9/2021,4526,295129,2108,2146,272,2990,108976,1530,93298,3261
San Mateo,3/10/2021,6906,302035,2634,3988,284,4559,111483,2335,95633,4842
San Mateo,3/11/2021,9109,311144,5717,2999,393,3699,110190,5384,101017,4091
San Mateo,3/12/2021,10479,321623,6601,3504,374,3491,107081,6974,107991,3865
San Mateo,3/13/2021,8092,329715,3407,3059,1626,3907,108436,4174,112165,5529
San Mateo,3/14/2021,4928,334643,3297,1524,107,2903,109427,2019,114184,3010
San Mateo,3/15/2021,7112,341755,4570,2368,174,3763,110021,3343,117527,3937
San Mateo,3/16/2021,11890,353645,4354,7413,123,4848,107968,7027,124554,4974
San Mateo,3/17/2021,10775,364420,4354,6297,124,4880,107104,5872,130426,5008
San Mateo,3/18/2021,7210,371630,4017,3010,183,4295,108669,2911,133337,4476
San Mateo,3/19/2021,7347,378977,4709,1971,667,3604,109204,3736,137073,4271
San Mateo,3/20/2021,8262,387239,6431,1497,334,5394,112078,2854,139927,5728
San Mateo,3/21/2021,4137,391376,3115,791,231,2339,112857,1788,141715,2567
San Mateo,3/22/2021,5211,396587,3538,1255,418,2859,113795,2340,144055,3278
San Mateo,3/23/2021,9746,406333,4425,5125,196,4641,113553,5079,149134,4837
San Mateo,3/24/2021,9419,415752,5423,3854,142,4096,112528,5260,154394,4235
San Mateo,3/25/2021,9968,425720,4852,4848,268,4391,111713,5477,159871,4662
San Mateo,3/26/2021,11091,436811,7641,3287,163,4428,109678,6627,166498,4592
San Mateo,3/27/2021,10386,447197,7946,2336,104,4657,108727,5709,172207,4758
San Mateo,3/28/2021,4191,451388,2696,1384,111,2086,108828,2097,174304,2198
San Mateo,3/29/2021,5993,457381,3740,2001,252,2843,108790,3133,177437,3095
San Mateo,3/30/2021,7032,464413,3982,2898,152,4454,110831,2565,180002,4606
San Mateo,3/31/2021,7157,471570,4531,2489,137,4057,111938,3087,183089,4194
San Mateo,4/1/2021,10349,481919,5080,4091,1178,5552,113903,4764,187853,6729
San Mateo,4/2/2021,10571,492490,5048,3965,1558,5537,115981,5016,192869,7094
San Mateo,4/3/2021,9587,502077,5441,2417,1729,4818,117770,4760,197629,6549
San Mateo,4/4/2021,5372,507449,2584,1543,1245,1697,117047,3665,201294,2942
San Mateo,4/5/2021,8902,516351,4726,2442,1734,3832,117554,5059,206353,5566
San Mateo,4/6/2021,13037,529388,8158,3032,1847,7444,121272,5581,211934,9299
San Mateo,4/7/2021,11263,540651,5215,4381,1667,4778,121245,6466,218400,6439
San Mateo,4/8/2021,9957,550608,4981,2427,2549,4422,122689,5522,223922,6966
San Mateo,4/9/2021,11181,561789,5421,3292,2468,5029,124044,6139,230061,7494
San Mateo,4/10/2021,11067,572856,5641,4013,1413,4585,123580,6460,236521,5996
San Mateo,4/11/2021,6594,579450,3268,880,2446,2324,124083,4264,240785,4767
San Mateo,4/12/2021,7274,586724,4455,1866,953,3539,124855,3721,244506,4493
San Mateo,4/13/2021,8080,594804,5051,3022,7,4284,125358,3791,248297,4294
San Mateo,4/14/2021,8213,603017,5328,2883,2,4306,125773,3897,252194,4312
San Mateo,4/15/2021,10875,613892,7229,3645,1,7152,129230,3698,255892,7155
San Mateo,4/16/2021,9829,623721,6822,2991,16,6282,132002,3531,259423,6303
San Mateo,4/17/2021,9320,633041,6176,3141,3,5997,134689,3315,262738,6002
San Mateo,4/18/2021,5291,638332,2484,2807,0,3576,136565,1706,264444,3582
San Mateo,4/19/2021,8065,646397,5355,2710,0,5168,138852,2888,267332,5175
San Mateo,4/20/2021,10125,656522,5572,4553,0,6506,141765,3603,270935,6516
San Mateo,4/21/2021,8120,664642,5398,2722,0,4790,143242,3320,274255,4797
San Mateo,4/22/2021,7419,672061,4922,2497,0,4201,144255,3193,277448,4206
San Mateo,4/23/2021,4227,676288,2741,1486,0,2655,145359,1562,279010,2666
Santa Barbara,12/15/2020,2,2,2,0,0,2,2,0,0,2
Santa Barbara,12/16/2020,2,4,2,0,0,2,4,0,0,2
Santa Barbara,12/17/2020,53,57,53,0,0,53,57,0,0,53
Santa Barbara,12/18/2020,377,434,376,1,0,377,434,0,0,377
Santa Barbara,12/19/2020,325,759,325,0,0,325,759,0,0,325
Santa Barbara,12/20/2020,235,994,235,0,0,235,994,0,0,235
Santa Barbara,12/21/2020,651,1645,649,2,0,651,1645,0,0,651
Santa Barbara,12/22/2020,243,1888,241,2,0,243,1888,0,0,243
Santa Barbara,12/23/2020,320,2208,202,118,0,320,2208,0,0,320
Santa Barbara,12/24/2020,87,2295,40,47,0,87,2295,0,0,87
Santa Barbara,12/26/2020,326,2621,66,260,0,326,2621,0,0,326
Santa Barbara,12/27/2020,62,2683,1,61,0,62,2683,0,0,62
Santa Barbara,12/28/2020,355,3038,222,133,0,355,3038,0,0,355
Santa Barbara,12/29/2020,554,3592,361,193,0,554,3592,0,0,554
Santa Barbara,12/30/2020,587,4179,405,182,0,587,4179,0,0,587
Santa Barbara,12/31/2020,239,4418,113,126,0,239,4418,0,0,239
Santa Barbara,1/1/2021,108,4526,107,1,0,108,4526,0,0,108
Santa Barbara,1/2/2021,587,5113,223,364,0,587,5113,0,0,587
Santa Barbara,1/3/2021,23,5136,15,8,0,23,5136,0,0,23
Santa Barbara,1/4/2021,308,5444,245,63,0,307,5443,0,0,307
Santa Barbara,1/5/2021,751,6195,378,373,0,724,6140,27,27,724
Santa Barbara,1/6/2021,654,6849,275,379,0,595,6677,58,85,595
Santa Barbara,1/7/2021,1030,7879,708,322,0,525,6701,501,586,525
Santa Barbara,1/8/2021,1201,9080,839,362,0,708,6916,493,1079,708
Santa Barbara,1/9/2021,566,9646,293,273,0,320,6990,246,1325,320
Santa Barbara,1/10/2021,62,9708,50,12,0,46,7020,16,1341,46
Santa Barbara,1/11/2021,837,10545,668,169,0,614,7412,222,1563,614
Santa Barbara,1/12/2021,1426,11971,634,792,0,1270,8526,156,1719,1270
Santa Barbara,1/13/2021,1227,13198,281,946,0,1101,9501,126,1845,1101
Santa Barbara,1/14/2021,1250,14448,134,1116,0,1196,10645,53,1898,1197
Santa Barbara,1/15/2021,1800,16248,419,1381,0,1719,12284,80,1978,1719
Santa Barbara,1/16/2021,1273,17521,203,1070,0,1234,13480,38,2016,1234
Santa Barbara,1/17/2021,123,17644,20,103,0,120,13597,3,2019,120
Santa Barbara,1/18/2021,1152,18796,417,735,0,967,14379,185,2204,967
Santa Barbara,1/19/2021,1638,20434,569,1069,0,1360,15462,277,2481,1360
Santa Barbara,1/20/2021,1997,22431,445,1552,0,1704,16874,292,2773,1704
Santa Barbara,1/21/2021,3085,25516,1818,1267,0,2930,19650,155,2928,2931
Santa Barbara,1/22/2021,3000,28516,1851,1149,0,2855,22363,142,3070,2855
Santa Barbara,1/23/2021,1735,30251,1106,629,0,1225,23079,509,3579,1225
Santa Barbara,1/24/2021,844,31095,752,92,0,835,23905,9,3588,835
Santa Barbara,1/25/2021,1238,32333,499,739,0,1000,24667,238,3826,1000
Santa Barbara,1/26/2021,2042,34375,466,1576,0,1655,25937,385,4211,1655
Santa Barbara,1/27/2021,1158,35533,398,760,0,901,26583,256,4467,902
Santa Barbara,1/28/2021,895,36428,297,598,0,681,27054,211,4678,682
Santa Barbara,1/29/2021,1332,37760,538,794,0,980,27687,349,5027,982
Santa Barbara,1/30/2021,1890,39650,1418,472,0,1486,28772,401,5428,1486
Santa Barbara,1/31/2021,1456,41106,1218,238,0,1417,30150,39,5467,1417
Santa Barbara,2/1/2021,938,42044,517,421,0,550,30312,388,5855,550
Santa Barbara,2/2/2021,1821,43865,699,1122,0,1046,30585,773,6628,1046
Santa Barbara,2/3/2021,1941,45806,1078,863,0,1499,31652,432,7060,1499
Santa Barbara,2/4/2021,2776,48582,1861,915,0,2481,33843,290,7350,2481
Santa Barbara,2/5/2021,2905,51487,2059,846,0,2262,35463,642,7992,2262
Santa Barbara,2/6/2021,1208,52695,339,869,0,796,35847,412,8404,796
Santa Barbara,2/7/2021,299,52994,262,37,0,264,36077,34,8438,264
Santa Barbara,2/8/2021,955,53949,311,644,0,669,36460,286,8724,669
Santa Barbara,2/9/2021,2439,56388,314,2125,0,1121,36272,1309,10033,1121
Santa Barbara,2/10/2021,2760,59148,1496,1264,0,803,35126,1949,11982,803
Santa Barbara,2/11/2021,4179,63327,2805,1374,0,623,32199,3550,15532,623
Santa Barbara,2/12/2021,3307,66634,948,2359,0,773,30443,2529,18061,773
Santa Barbara,2/13/2021,1237,67871,341,896,0,562,30333,672,18733,562
Santa Barbara,2/14/2021,331,68202,34,297,0,285,30572,46,18779,285
Santa Barbara,2/15/2021,964,69166,337,627,0,491,30594,469,19248,491
Santa Barbara,2/16/2021,2109,71275,396,1713,0,716,29921,1389,20637,716
Santa Barbara,2/17/2021,1436,72711,322,1114,0,521,29529,913,21550,521
Santa Barbara,2/18/2021,3251,75962,2646,605,0,1518,29348,1699,23249,1518
Santa Barbara,2/19/2021,3603,79565,2648,955,0,2334,30416,1266,24515,2334
Santa Barbara,2/20/2021,2219,81784,1432,787,0,1667,31540,543,25058,1667
Santa Barbara,2/21/2021,124,81908,97,27,0,57,31530,67,25125,57
Santa Barbara,2/22/2021,934,82842,243,691,0,262,31126,666,25791,262
Santa Barbara,2/23/2021,3181,86023,1043,2138,0,419,28785,2760,28551,419
Santa Barbara,2/24/2021,3195,89218,1086,2109,0,721,27041,2465,31016,721
Santa Barbara,2/25/2021,3452,92670,1916,1536,0,985,25567,2460,33476,986
Santa Barbara,2/26/2021,3664,96334,2174,1490,0,1980,25870,1677,35153,1980
Santa Barbara,2/27/2021,1527,97861,561,966,0,846,26043,675,35828,848
Santa Barbara,2/28/2021,1082,98943,220,862,0,891,26748,187,36015,892
Santa Barbara,3/1/2021,1622,100565,461,1161,0,1080,27296,533,36548,1081
Santa Barbara,3/2/2021,2609,103174,411,2198,0,2115,28929,483,37031,2116
Santa Barbara,3/3/2021,4625,107799,2096,2528,1,4033,32384,582,37613,4037
Santa Barbara,3/4/2021,3410,111209,2281,1129,0,2857,34694,547,38160,2857
Santa Barbara,3/5/2021,3801,115010,2152,1590,59,3079,37116,716,38876,3138
Santa Barbara,3/6/2021,2436,117446,726,1491,219,1671,38243,762,39638,1889
Santa Barbara,3/7/2021,557,118003,122,307,128,381,38578,175,39813,510
Santa Barbara,3/8/2021,1570,119573,374,854,342,790,38936,774,40587,1132
Santa Barbara,3/9/2021,2765,122338,323,1672,770,717,38374,2045,42632,1483
Santa Barbara,3/10/2021,2750,125088,544,1160,1046,1033,38741,1712,44344,2079
Santa Barbara,3/11/2021,5573,130661,3031,1428,1114,2279,38848,3282,47626,3389
Santa Barbara,3/12/2021,3651,134312,2094,1130,427,2172,39974,1471,49097,2597
Santa Barbara,3/13/2021,3469,137781,1920,1340,209,2695,42106,773,49870,2905
Santa Barbara,3/14/2021,775,138556,366,352,57,457,42302,318,50188,514
Santa Barbara,3/15/2021,2102,140658,694,1117,291,1266,43024,833,51021,1555
Santa Barbara,3/16/2021,3725,144383,1170,2214,341,2742,45127,980,52001,3083
Santa Barbara,3/17/2021,3297,147680,970,1922,405,2307,46849,988,52989,2710
Santa Barbara,3/18/2021,5115,152795,2796,2119,200,3896,49738,1207,54196,4096
Santa Barbara,3/19/2021,4435,157230,2762,1341,332,3045,51728,1386,55582,3376
Santa Barbara,3/20/2021,2159,159389,825,1324,10,1324,52229,833,56415,1334
Santa Barbara,3/21/2021,1161,160550,382,750,29,838,52774,322,56737,867
Santa Barbara,3/22/2021,2776,163326,1914,819,43,2226,54499,544,57281,2269
Santa Barbara,3/23/2021,4470,167796,2246,2128,96,3711,57556,750,58031,3807
Santa Barbara,3/24/2021,5383,173179,3154,1496,733,2953,58830,2411,60442,3685
Santa Barbara,3/25/2021,5533,178712,3278,2069,186,2765,59027,2754,63196,2951
Santa Barbara,3/26/2021,5070,183782,3214,1558,298,2236,58743,2818,66014,2534
Santa Barbara,3/27/2021,2927,186709,1222,1662,43,1595,59052,1327,67341,1636
Santa Barbara,3/28/2021,2777,189486,1653,1096,28,1896,60098,878,68219,1924
Santa Barbara,3/29/2021,4041,193527,2087,1885,69,3236,62603,800,69019,3305
Santa Barbara,3/30/2021,6780,200307,3501,3131,148,4557,65097,2209,71228,4703
Santa Barbara,3/31/2021,8625,208932,5498,3063,64,5051,66655,3558,74786,5116
Santa Barbara,4/1/2021,6891,215823,5082,1551,258,4049,68130,2830,77616,4305
Santa Barbara,4/2/2021,6595,222418,4526,1477,592,3384,68901,3204,80820,3975
Santa Barbara,4/3/2021,3779,226197,2100,1611,68,2489,70171,1286,82106,2556
Santa Barbara,4/4/2021,894,227091,442,412,40,496,70311,396,82502,536
Santa Barbara,4/5/2021,3437,230528,2265,914,258,2145,71429,1286,83788,2404
Santa Barbara,4/6/2021,5447,235975,2815,2097,535,3335,73199,2098,85886,3868
Santa Barbara,4/7/2021,5986,241961,3287,2159,540,4083,75928,1892,87778,4621
Santa Barbara,4/8/2021,7375,249336,5027,635,1713,3411,77089,3961,91739,5122
Santa Barbara,4/9/2021,7282,256618,4864,1074,1344,3297,77751,3976,95715,4638
Santa Barbara,4/10/2021,6625,263243,4599,1411,615,4517,80779,2104,97819,5132
Santa Barbara,4/11/2021,2660,265903,1947,414,299,1840,82099,815,98634,2135
Santa Barbara,4/12/2021,4446,270349,2865,1027,554,1940,82091,2500,101134,2492
Santa Barbara,4/13/2021,6297,276646,4136,2155,6,2610,81022,3684,104818,2615
Santa Barbara,4/14/2021,6738,283384,4418,2318,2,4225,82745,2503,107321,4226
Santa Barbara,4/15/2021,6930,290314,4093,2836,1,3846,83521,3072,110393,3848
Santa Barbara,4/16/2021,6356,296670,3748,2597,11,4381,85952,1960,112353,4391
Santa Barbara,4/17/2021,5303,301973,3872,1431,0,4098,88853,1197,113550,4098
Santa Barbara,4/18/2021,2119,304092,1471,648,0,370,87478,1746,115296,371
Santa Barbara,4/19/2021,3178,307270,2212,961,5,991,86291,2184,117480,997
Santa Barbara,4/20/2021,5864,313134,3954,1909,1,1661,83761,4191,121671,1661
Santa Barbara,4/21/2021,5453,318587,3636,1817,0,1745,81810,3696,125367,1745
Santa Barbara,4/22/2021,4817,323404,2407,2410,0,1378,79763,3426,128793,1379
Santa Barbara,4/23/2021,2262,325666,1691,571,0,1047,79601,1209,130002,1047
Santa Clara,12/15/2020,65,65,65,0,0,65,65,0,0,65
Santa Clara,12/16/2020,136,201,136,0,0,136,201,0,0,136
Santa Clara,12/17/2020,390,591,390,0,0,390,591,0,0,390
Santa Clara,12/18/2020,1674,2265,1674,0,0,1674,2265,0,0,1674
Santa Clara,12/19/2020,2072,4337,2072,0,0,2071,4336,0,0,2071
Santa Clara,12/20/2020,1898,6235,1892,6,0,1895,6231,0,0,1895
Santa Clara,12/21/2020,2668,8903,2668,0,0,2666,8897,0,0,2666
Santa Clara,12/22/2020,3125,12028,3116,9,0,3122,12019,0,0,3122
Santa Clara,12/23/2020,3258,15286,3073,185,0,3256,15275,0,0,3256
Santa Clara,12/24/2020,1899,17185,1712,187,0,1893,17167,1,1,1893
Santa Clara,12/25/2020,343,17528,342,1,0,343,17510,0,1,343
Santa Clara,12/26/2020,1263,18791,1031,232,0,1262,18772,0,1,1262
Santa Clara,12/27/2020,647,19438,507,140,0,647,19419,0,1,647
Santa Clara,12/28/2020,2331,21769,1729,602,0,2331,21750,0,1,2331
Santa Clara,12/29/2020,2326,24095,1466,860,0,2324,24074,0,1,2324
Santa Clara,12/30/2020,2987,27082,1898,1089,0,2985,27057,2,3,2985
Santa Clara,12/31/2020,1211,28293,387,824,0,1210,28266,1,4,1210
Santa Clara,1/1/2021,138,28431,8,130,0,138,28404,0,4,138
Santa Clara,1/2/2021,1081,29512,812,269,0,1081,29485,0,4,1081
Santa Clara,1/3/2021,584,30096,369,215,0,579,30061,3,7,579
Santa Clara,1/4/2021,2465,32561,1666,799,0,2463,32524,0,7,2463
Santa Clara,1/5/2021,3056,35617,2001,1055,0,2868,35211,187,194,2874
Santa Clara,1/6/2021,3319,38936,1954,1365,0,2744,37385,571,765,2745
Santa Clara,1/7/2021,4212,43148,2554,1658,0,3146,39480,1056,1821,3151
Santa Clara,1/8/2021,5840,48988,3820,2020,0,3787,41218,2049,3870,3787
Santa Clara,1/9/2021,2969,51957,1862,1107,0,1686,41624,1283,5153,1689
Santa Clara,1/10/2021,1952,53909,1509,443,0,740,41153,1211,6364,740
Santa Clara,1/11/2021,5932,59841,3733,2199,0,3373,41973,2558,8922,3378
Santa Clara,1/12/2021,6799,66640,3398,3401,0,4556,44289,2241,11163,4557
Santa Clara,1/13/2021,7360,74000,3041,4319,0,5193,47318,2165,13328,5194
Santa Clara,1/14/2021,8227,82227,2790,5437,0,6489,52075,1733,15061,6490
Santa Clara,1/15/2021,9445,91672,2680,6765,0,8130,58898,1312,16373,8135
Santa Clara,1/16/2021,4295,95967,1224,3071,0,3463,61533,828,17201,3463
Santa Clara,1/17/2021,3213,99180,601,2612,0,2717,63754,496,17697,2717
Santa Clara,1/18/2021,5086,104266,1149,3937,0,4534,67737,552,18249,4535
Santa Clara,1/19/2021,8460,112726,2658,5802,0,6785,72853,1672,19921,6788
Santa Clara,1/20/2021,7985,120711,4014,3971,0,6446,77765,1534,21455,6446
Santa Clara,1/21/2021,8542,129253,3633,4909,0,7393,84013,1147,22602,7395
Santa Clara,1/22/2021,8582,137835,3202,5380,0,8019,91472,562,23164,8021
Santa Clara,1/23/2021,3780,141615,1687,2093,0,2823,93339,957,24121,2824
Santa Clara,1/24/2021,2824,144439,1421,1403,0,2337,95191,485,24606,2337
Santa Clara,1/25/2021,8362,152801,3778,4584,0,6307,99454,2048,26654,6311
Santa Clara,1/26/2021,8228,161029,3760,4468,0,6117,103472,2101,28755,6119
Santa Clara,1/27/2021,8704,169733,3823,4881,0,6784,108358,1899,30654,6785
Santa Clara,1/28/2021,9412,179145,3769,5643,0,7464,113898,1928,32582,7468
Santa Clara,1/29/2021,9498,188643,3935,5563,0,7334,119080,2155,34737,7337
Santa Clara,1/30/2021,4167,192810,2061,2106,0,2963,120847,1197,35934,2964
Santa Clara,1/31/2021,2170,194980,1302,868,0,1580,121840,587,36521,1580
Santa Clara,2/1/2021,7826,202806,3480,4346,0,6140,126302,1679,38200,6141
Santa Clara,2/2/2021,8292,211098,2869,5423,0,6303,130624,1984,40184,6306
Santa Clara,2/3/2021,9191,220289,3480,5711,0,6919,135283,2266,42450,6925
Santa Clara,2/4/2021,10883,231172,4109,6774,0,8604,141621,2269,44719,8607
Santa Clara,2/5/2021,11903,243075,4345,7558,0,8447,146628,3441,48160,8448
Santa Clara,2/6/2021,5173,248248,2808,2365,0,4013,149487,1156,49316,4015
Santa Clara,2/7/2021,3470,251718,2347,1123,0,3019,152057,450,49766,3020
Santa Clara,2/8/2021,10000,261718,3476,6524,0,7289,156650,2697,52463,7290
Santa Clara,2/9/2021,11129,272847,3808,7321,0,7653,160840,3466,55929,7656
Santa Clara,2/10/2021,12619,285466,4894,7725,0,6904,162044,5702,61631,6906
Santa Clara,2/11/2021,13452,298918,4697,8755,0,7667,163941,5771,67402,7668
Santa Clara,2/12/2021,14529,313447,4477,10052,0,7012,163457,7498,74900,7014
Santa Clara,2/13/2021,6061,319508,1447,4614,0,2209,161822,3846,78746,2211
Santa Clara,2/14/2021,4612,324120,1140,3472,0,1468,160149,3143,81889,1470
Santa Clara,2/15/2021,6243,330363,2794,3449,0,2701,159314,3536,85425,2701
Santa Clara,2/16/2021,13747,344110,3991,9756,0,6915,159414,6815,92240,6915
Santa Clara,2/17/2021,14054,358164,5485,8569,0,7040,159463,6996,99236,7045
Santa Clara,2/18/2021,13691,371855,8345,5346,0,7000,159798,6668,105904,7003
Santa Clara,2/19/2021,14676,386531,9513,5163,0,8495,162131,6166,112070,8499
Santa Clara,2/20/2021,6807,393338,5093,1714,0,3673,162679,3125,115195,3673
Santa Clara,2/21/2021,3240,396578,2424,816,0,1163,161774,2070,117265,1165
Santa Clara,2/22/2021,10142,406720,6075,4067,0,4734,161111,5398,122663,4735
Santa Clara,2/23/2021,11835,418555,7694,4141,0,6710,162711,5114,127777,6714
Santa Clara,2/24/2021,14110,432665,9084,5026,0,8736,166089,5358,133135,8736
Santa Clara,2/25/2021,14567,447232,9222,5345,0,7865,167275,6684,139819,7870
Santa Clara,2/26/2021,14547,461779,8432,6115,0,7998,168753,6523,146342,8001
Santa Clara,2/27/2021,8042,469821,5488,2553,1,4450,169629,3582,149924,4458
Santa Clara,2/28/2021,4713,474534,3066,1647,0,2204,169333,2500,152424,2204
Santa Clara,3/1/2021,14049,488583,7964,6083,2,8692,172690,5337,157761,8694
Santa Clara,3/2/2021,15756,504339,9376,6380,0,10213,177385,5519,163280,10214
Santa Clara,3/3/2021,18264,522603,8892,9371,1,11321,181807,6906,170186,11328
Santa Clara,3/4/2021,16335,538938,8905,7427,3,9531,184605,6738,176924,9536
Santa Clara,3/5/2021,16423,555361,9115,7183,125,9111,186552,7293,184217,9240
Santa Clara,3/6/2021,9339,564700,6263,2641,435,7038,191737,2288,186505,7473
Santa Clara,3/7/2021,6713,571413,4405,2077,231,5349,195960,1356,187861,5579
Santa Clara,3/8/2021,12826,584239,6679,5586,561,8215,200143,4595,192456,8778
Santa Clara,3/9/2021,14789,599028,6207,7256,1326,6545,199785,8227,200683,7869
Santa Clara,3/10/2021,14862,613890,6462,6382,2018,6066,199081,8772,209455,8068
Santa Clara,3/11/2021,16883,630773,7726,7654,1503,5973,195663,10883,220338,7465
Santa Clara,3/12/2021,17603,648376,9047,6986,1570,5934,191524,11630,231968,7491
Santa Clara,3/13/2021,10665,659041,6177,3003,1485,4762,191878,5880,237848,6234
Santa Clara,3/14/2021,6466,665507,3345,1822,1299,3191,193101,3260,241108,4483
Santa Clara,3/15/2021,12732,678239,6509,5955,268,5960,192577,6753,247861,6229
Santa Clara,3/16/2021,18104,696343,10242,7656,206,8769,192242,9308,257169,8973
Santa Clara,3/17/2021,19784,716127,11207,8409,168,10213,193095,9523,266692,10376
Santa Clara,3/18/2021,18934,735061,8847,8929,1158,9131,193632,9749,276441,10286
Santa Clara,3/19/2021,19118,754179,9827,8293,998,10006,195571,9056,285497,10995
Santa Clara,3/20/2021,11429,765608,6277,4325,827,6717,198427,4684,290181,7540
Santa Clara,3/21/2021,8234,773842,3715,3119,1400,5521,202635,2704,292885,6912
Santa Clara,3/22/2021,16216,790058,9041,6831,344,9264,205313,6930,299815,9608
Santa Clara,3/23/2021,19115,809173,12162,6440,513,11236,209227,7835,307650,11749
Santa Clara,3/24/2021,22461,831634,14474,7576,411,14636,216492,7784,315434,15049
Santa Clara,3/25/2021,22777,854411,13048,8746,983,14697,224147,8016,323450,15671
Santa Clara,3/26/2021,21748,876159,13857,7508,383,13446,229704,8267,331717,13824
Santa Clara,3/27/2021,15571,891730,10361,4448,762,8392,231715,7142,338859,9153
Santa Clara,3/28/2021,11972,903702,8276,2983,713,6475,233425,5474,344333,7184
Santa Clara,3/29/2021,20479,924181,12570,7185,724,11145,235997,9294,353627,11866
Santa Clara,3/30/2021,25418,949599,15136,8350,1932,16260,245061,9123,362750,18187
Santa Clara,3/31/2021,20238,969837,11737,7379,1122,12543,251055,7663,370413,13657
Santa Clara,4/1/2021,31326,1001163,19600,8743,2983,19781,262324,11487,381900,22756
Santa Clara,4/2/2021,24817,1025980,14179,8527,2111,16194,272031,8592,390492,18299
Santa Clara,4/3/2021,15026,1041006,9113,3433,2480,8323,276142,6684,397176,10795
Santa Clara,4/4/2021,7559,1048565,4003,2404,1152,3931,277606,3619,400795,5083
Santa Clara,4/5/2021,21459,1070024,14303,4705,2451,13977,286574,7458,408253,16426
Santa Clara,4/6/2021,29101,1099125,15993,7701,5407,17454,297821,11607,419860,22854
Santa Clara,4/7/2021,30408,1129533,15678,8309,6421,18545,310964,11811,431671,24954
Santa Clara,4/8/2021,28925,1158458,15939,5911,7075,15933,321036,12921,444592,22993
Santa Clara,4/9/2021,27486,1185944,13588,6745,7153,13996,328729,13439,458031,21132
Santa Clara,4/10/2021,21109,1207053,12212,3712,5185,11296,335402,9782,467813,16455
Santa Clara,4/11/2021,15875,1222928,9495,2622,3758,8213,339736,7630,475443,11964
Santa Clara,4/12/2021,26597,1249525,18716,5485,2396,18139,351864,8405,483848,20533
Santa Clara,4/13/2021,33408,1282933,26768,6614,26,25930,370442,7401,491249,25979
Santa Clara,4/14/2021,35829,1318762,27088,8738,3,25806,386315,9963,501212,25836
Santa Clara,4/15/2021,42999,1361761,33894,9105,0,33358,410153,9544,510756,33382
Santa Clara,4/16/2021,37690,1399451,26092,11596,2,27315,427183,10308,521064,27338
Santa Clara,4/17/2021,21333,1420784,14835,6497,1,14856,435621,6435,527499,14873
Santa Clara,4/18/2021,15757,1436541,10025,5732,0,9688,439282,6037,533536,9698
Santa Clara,4/19/2021,27889,1464430,19988,7900,1,16758,445005,11064,544600,16787
Santa Clara,4/20/2021,35132,1499562,21032,14100,0,21369,452735,13667,558267,21397
Santa Clara,4/21/2021,20462,1520024,11982,8480,0,10420,453187,9995,568262,10447
Santa Clara,4/22/2021,14913,1534937,8590,6322,1,6409,451160,8453,576715,6426
Santa Clara,4/23/2021,7509,1542446,3762,3747,0,3065,449810,4424,581139,3074
Santa Cruz,12/15/2020,2,2,2,0,0,2,2,0,0,2
Santa Cruz,12/16/2020,57,59,57,0,0,57,59,0,0,57
Santa Cruz,12/17/2020,389,448,389,0,0,389,448,0,0,389
Santa Cruz,12/18/2020,464,912,464,0,0,464,912,0,0,464
Santa Cruz,12/19/2020,178,1090,177,1,0,178,1090,0,0,178
Santa Cruz,12/20/2020,95,1185,95,0,0,95,1185,0,0,95
Santa Cruz,12/21/2020,435,1620,435,0,0,435,1620,0,0,435
Santa Cruz,12/22/2020,424,2044,423,1,0,424,2044,0,0,424
Santa Cruz,12/23/2020,372,2416,329,43,0,372,2416,0,0,372
Santa Cruz,12/24/2020,125,2541,49,76,0,125,2541,0,0,125
Santa Cruz,12/25/2020,11,2552,11,0,0,11,2552,0,0,11
Santa Cruz,12/26/2020,64,2616,45,19,0,64,2616,0,0,64
Santa Cruz,12/27/2020,32,2648,27,5,0,32,2648,0,0,32
Santa Cruz,12/28/2020,485,3133,108,377,0,485,3133,0,0,485
Santa Cruz,12/29/2020,800,3933,370,430,0,800,3933,0,0,800
Santa Cruz,12/30/2020,356,4289,164,192,0,356,4289,0,0,356
Santa Cruz,12/31/2020,313,4602,11,302,0,313,4602,0,0,313
Santa Cruz,1/1/2021,33,4635,1,32,0,33,4635,0,0,33
Santa Cruz,1/2/2021,71,4706,57,14,0,71,4706,0,0,71
Santa Cruz,1/3/2021,15,4721,7,8,0,15,4721,0,0,15
Santa Cruz,1/4/2021,281,5002,123,158,0,279,5000,0,0,279
Santa Cruz,1/5/2021,566,5568,428,138,0,264,4962,302,302,264
Santa Cruz,1/6/2021,802,6370,669,133,0,464,5089,337,639,464
Santa Cruz,1/7/2021,541,6911,212,329,0,388,5325,153,792,389
Santa Cruz,1/8/2021,932,7843,560,372,0,485,5364,447,1239,486
Santa Cruz,1/9/2021,463,8306,123,340,0,409,5719,54,1293,409
Santa Cruz,1/10/2021,80,8386,70,10,0,21,5681,59,1352,21
Santa Cruz,1/11/2021,723,9109,589,134,0,191,5340,532,1884,191
Santa Cruz,1/12/2021,736,9845,532,204,0,493,5590,243,2127,493
Santa Cruz,1/13/2021,522,10367,228,294,0,438,5947,81,2208,438
Santa Cruz,1/14/2021,555,10922,101,454,0,489,6370,66,2274,489
Santa Cruz,1/15/2021,1459,12381,77,1382,0,1394,7702,64,2338,1396
Santa Cruz,1/16/2021,426,12807,54,372,0,407,8090,19,2357,407
Santa Cruz,1/17/2021,297,13104,41,256,0,272,8337,25,2382,272
Santa Cruz,1/18/2021,1015,14119,105,910,0,953,9228,62,2444,953
Santa Cruz,1/19/2021,1622,15741,524,1098,0,1269,10147,351,2795,1270
Santa Cruz,1/20/2021,1235,16976,183,1052,0,1038,10991,194,2989,1038
Santa Cruz,1/21/2021,1712,18688,200,1512,0,1604,12489,108,3097,1606
Santa Cruz,1/22/2021,1796,20484,532,1264,0,1694,14085,99,3196,1695
Santa Cruz,1/23/2021,402,20886,147,255,0,342,14368,59,3255,342
Santa Cruz,1/24/2021,116,21002,21,95,0,98,14448,18,3273,98
Santa Cruz,1/25/2021,1062,22064,361,701,0,551,14488,511,3784,551
Santa Cruz,1/26/2021,1695,23759,248,1447,0,1182,15157,513,4297,1182
Santa Cruz,1/27/2021,1653,25412,449,1204,0,1269,16044,382,4679,1269
Santa Cruz,1/28/2021,1749,27161,293,1456,0,1472,17240,277,4956,1473
Santa Cruz,1/29/2021,1733,28894,489,1244,0,1603,18714,129,5085,1603
Santa Cruz,1/30/2021,1059,29953,308,751,0,926,19507,133,5218,926
Santa Cruz,1/31/2021,221,30174,113,108,0,207,19700,14,5232,207
Santa Cruz,2/1/2021,1232,31406,759,473,0,826,20120,406,5638,826
Santa Cruz,2/2/2021,1008,32414,128,880,0,853,20819,154,5792,853
Santa Cruz,2/3/2021,2237,34651,960,1277,0,1922,22430,311,6103,1922
Santa Cruz,2/4/2021,1855,36506,773,1082,0,1518,23612,336,6439,1518
Santa Cruz,2/5/2021,3172,39678,793,2379,0,2852,26145,319,6758,2852
Santa Cruz,2/6/2021,2588,42266,164,2424,0,2240,28037,348,7106,2240
Santa Cruz,2/7/2021,909,43175,122,787,0,891,28910,18,7124,891
Santa Cruz,2/8/2021,715,43890,202,513,0,515,29226,199,7323,515
Santa Cruz,2/9/2021,2373,46263,1056,1317,0,2110,31077,259,7582,2110
Santa Cruz,2/10/2021,2201,48464,579,1622,0,1502,31890,690,8272,1503
Santa Cruz,2/11/2021,1856,50320,317,1539,0,1329,32694,525,8797,1329
Santa Cruz,2/12/2021,3225,53545,421,2804,0,1815,33109,1402,10199,1817
Santa Cruz,2/13/2021,1710,55255,124,1586,0,1296,33991,414,10613,1296
Santa Cruz,2/14/2021,1403,56658,70,1333,0,1139,34866,264,10877,1139
Santa Cruz,2/15/2021,1583,58241,280,1303,0,566,34416,1017,11894,567
Santa Cruz,2/16/2021,1696,59937,206,1490,0,537,33815,1138,13032,537
Santa Cruz,2/17/2021,2922,62859,976,1946,0,1221,33351,1688,14720,1224
Santa Cruz,2/18/2021,2881,65740,639,2242,0,1230,32934,1647,16367,1230
Santa Cruz,2/19/2021,3266,69006,1145,2121,0,2009,33688,1255,17622,2009
Santa Cruz,2/20/2021,2386,71392,1499,887,0,1892,35086,494,18116,1892
Santa Cruz,2/21/2021,826,72218,360,466,0,700,35662,124,18240,700
Santa Cruz,2/22/2021,1258,73476,967,291,0,535,35476,721,18961,535
Santa Cruz,2/23/2021,2097,75573,938,1159,0,708,34796,1388,20349,708
Santa Cruz,2/24/2021,3182,78755,1664,1518,0,1203,34024,1975,22324,1203
Santa Cruz,2/25/2021,3239,81994,1431,1808,0,1781,34354,1451,23775,1781
Santa Cruz,2/26/2021,2721,84715,763,1958,0,1549,34737,1168,24943,1551
Santa Cruz,2/27/2021,2635,87350,930,1705,0,1836,35775,798,25741,1836
Santa Cruz,2/28/2021,1296,88646,359,937,0,1084,36650,209,25950,1084
Santa Cruz,3/1/2021,1828,90474,1255,573,0,689,36203,1136,27086,689
Santa Cruz,3/2/2021,1527,92001,357,1170,0,855,36391,670,27756,858
Santa Cruz,3/3/2021,2345,94346,607,1738,0,1274,36597,1068,28824,1274
Santa Cruz,3/4/2021,3007,97353,1406,1600,1,2023,37649,973,29797,2025
Santa Cruz,3/5/2021,2601,99954,476,2107,18,1121,37311,1477,31274,1139
Santa Cruz,3/6/2021,3869,103823,1346,2418,105,2157,37859,1712,32986,2260
Santa Cruz,3/7/2021,1346,105169,128,1144,74,555,37698,790,33776,629
Santa Cruz,3/8/2021,1080,106249,219,732,129,650,38048,429,34205,779
Santa Cruz,3/9/2021,1772,108021,238,1387,147,700,37825,1070,35275,847
Santa Cruz,3/10/2021,3859,111880,2089,1621,149,1996,38111,1861,37136,2147
Santa Cruz,3/11/2021,2805,114685,1218,1412,175,1549,38582,1255,38391,1726
Santa Cruz,3/12/2021,2755,117440,890,1573,292,908,37937,1844,40235,1199
Santa Cruz,3/13/2021,2309,119749,1333,932,44,1177,38029,1130,41365,1222
Santa Cruz,3/14/2021,902,120651,215,673,14,440,38022,460,41825,453
Santa Cruz,3/15/2021,1353,122004,484,834,35,582,37872,768,42593,618
Santa Cruz,3/16/2021,2318,124322,1088,1189,41,1343,38283,972,43565,1383
Santa Cruz,3/17/2021,3869,128191,2234,1625,10,2523,39477,1342,44907,2536
Santa Cruz,3/18/2021,3867,132058,2095,1652,120,2071,39875,1793,46700,2191
Santa Cruz,3/19/2021,3283,135341,1324,1734,225,1656,40134,1622,48322,1881
Santa Cruz,3/20/2021,2167,137508,1614,516,37,1095,40197,1069,49391,1132
Santa Cruz,3/21/2021,826,138334,438,266,122,444,40384,380,49771,567
Santa Cruz,3/22/2021,1372,139706,848,502,22,941,40920,428,50199,964
Santa Cruz,3/23/2021,2570,142276,1444,1076,50,1717,41836,851,51050,1767
Santa Cruz,3/24/2021,3019,145295,2030,967,22,2000,42843,1014,52064,2021
Santa Cruz,3/25/2021,2642,147937,1330,1277,35,1358,42960,1276,53340,1393
Santa Cruz,3/26/2021,3035,150972,1828,1180,27,2063,44085,965,54305,2090
Santa Cruz,3/27/2021,3238,154210,2014,1199,25,1530,43944,1697,56002,1556
Santa Cruz,3/28/2021,927,155137,569,344,14,493,44022,429,56431,507
Santa Cruz,3/29/2021,1957,157094,878,1011,68,1258,44652,696,57127,1326
Santa Cruz,3/30/2021,2706,159800,817,1726,163,1735,45581,969,58096,1898
Santa Cruz,3/31/2021,4062,163862,2722,1292,48,2086,45743,1972,60068,2134
Santa Cruz,4/1/2021,4021,167883,2152,1762,107,2026,45886,1990,62058,2133
Santa Cruz,4/2/2021,3145,171028,1427,1536,182,1740,46408,1400,63458,1922
Santa Cruz,4/3/2021,2260,173288,1234,893,133,890,46063,1367,64825,1022
Santa Cruz,4/4/2021,937,174225,492,390,55,552,46285,385,65210,607
Santa Cruz,4/5/2021,2263,176488,798,1294,171,1394,46982,868,66078,1565
Santa Cruz,4/6/2021,3378,179866,1670,1328,380,1988,47967,1380,67458,2365
Santa Cruz,4/7/2021,4148,184014,1636,2150,362,1864,47912,2280,69738,2225
Santa Cruz,4/8/2021,4266,188280,2350,1402,514,2513,49192,1744,71482,3024
Santa Cruz,4/9/2021,3580,191860,1522,1657,401,1981,49981,1594,73076,2383
Santa Cruz,4/10/2021,2261,194121,1101,910,250,1077,50126,1181,74257,1326
Santa Cruz,4/11/2021,1001,195122,527,382,92,487,50191,514,74771,579
Santa Cruz,4/12/2021,2304,197426,832,1038,434,1103,50541,1186,75957,1536
Santa Cruz,4/13/2021,2898,200324,1459,1437,2,1632,50914,1261,77218,1634
Santa Cruz,4/14/2021,4601,204925,2221,2380,0,2382,51087,2210,79428,2383
Santa Cruz,4/15/2021,4788,209713,2979,1809,0,3136,52581,1642,81070,3136
Santa Cruz,4/16/2021,4420,214133,2540,1878,2,2468,53107,1945,83015,2471
Santa Cruz,4/17/2021,2241,216374,893,1348,0,1485,53837,755,83770,1485
Santa Cruz,4/18/2021,1067,217441,507,560,0,592,53956,473,84243,592
Santa Cruz,4/19/2021,2423,219864,1515,907,1,1496,54527,925,85168,1496
Santa Cruz,4/20/2021,3115,222979,1693,1422,0,1778,54979,1327,86495,1779
Santa Cruz,4/21/2021,4094,227073,2809,1285,0,2245,55391,1834,88329,2246
Santa Cruz,4/22/2021,3813,230886,2641,1172,0,2177,55940,1629,89958,2178
Santa Cruz,4/23/2021,1709,232595,1127,581,1,763,55760,944,90902,764
Shasta,12/16/2020,131,131,131,0,0,131,131,0,0,131
Shasta,12/17/2020,417,548,417,0,0,417,548,0,0,417
Shasta,12/18/2020,166,714,166,0,0,166,714,0,0,166
Shasta,12/19/2020,1,715,1,0,0,1,715,0,0,1
Shasta,12/21/2020,80,795,80,0,0,80,795,0,0,80
Shasta,12/22/2020,191,986,186,5,0,191,986,0,0,191
Shasta,12/23/2020,174,1160,170,4,0,174,1160,0,0,174
Shasta,12/24/2020,18,1178,18,0,0,18,1178,0,0,18
Shasta,12/26/2020,4,1182,1,3,0,4,1182,0,0,4
Shasta,12/27/2020,1,1183,0,1,0,1,1183,0,0,1
Shasta,12/28/2020,40,1223,31,9,0,40,1223,0,0,40
Shasta,12/29/2020,186,1409,185,1,0,186,1409,0,0,186
Shasta,12/30/2020,178,1587,168,10,0,178,1587,0,0,178
Shasta,12/31/2020,83,1670,2,81,0,83,1670,0,0,83
Shasta,1/2/2021,2,1672,0,2,0,2,1672,0,0,2
Shasta,1/3/2021,1,1673,1,0,0,1,1673,0,0,1
Shasta,1/4/2021,347,2020,306,41,0,348,2021,0,0,348
Shasta,1/5/2021,335,2355,314,21,0,254,2194,81,81,254
Shasta,1/6/2021,437,2792,395,42,0,175,2108,261,342,175
Shasta,1/7/2021,116,2908,35,81,0,95,2182,21,363,95
Shasta,1/8/2021,507,3415,447,60,0,299,2273,208,571,299
Shasta,1/9/2021,72,3487,63,9,0,70,2341,2,573,70
Shasta,1/10/2021,5,3492,0,5,0,4,2345,1,574,5
Shasta,1/11/2021,353,3845,185,168,0,317,2626,36,610,317
Shasta,1/12/2021,444,4289,327,117,0,270,2722,174,784,270
Shasta,1/13/2021,541,4830,268,273,0,371,2923,170,954,371
Shasta,1/14/2021,453,5283,51,402,0,435,3340,18,972,435
Shasta,1/15/2021,638,5921,136,502,0,636,3974,2,974,636
Shasta,1/16/2021,898,6819,54,844,0,895,4866,3,977,895
Shasta,1/17/2021,27,6846,6,21,0,23,4885,4,981,23
Shasta,1/18/2021,598,7444,129,469,0,590,5467,8,989,590
Shasta,1/19/2021,1018,8462,397,621,0,870,6189,148,1137,870
Shasta,1/20/2021,677,9139,409,268,0,493,6503,179,1316,493
Shasta,1/21/2021,630,9769,277,353,0,607,7087,23,1339,607
Shasta,1/22/2021,446,10215,171,275,0,440,7521,6,1345,440
Shasta,1/23/2021,68,10283,5,63,0,67,7587,1,1346,67
Shasta,1/24/2021,25,10308,2,23,0,24,7610,1,1347,24
Shasta,1/25/2021,750,11058,491,259,0,464,7789,285,1632,464
Shasta,1/26/2021,708,11766,332,376,0,475,8033,231,1863,475
Shasta,1/27/2021,459,12225,179,280,0,410,8394,49,1912,410
Shasta,1/28/2021,855,13080,576,279,0,633,8805,222,2134,633
Shasta,1/29/2021,831,13911,330,501,0,641,9257,190,2324,642
Shasta,1/30/2021,616,14527,14,602,0,607,9855,9,2333,607
Shasta,1/31/2021,28,14555,4,24,0,26,9879,2,2335,26
Shasta,2/1/2021,510,15065,148,362,0,386,10141,124,2459,386
Shasta,2/2/2021,938,16003,493,445,0,847,10899,89,2548,847
Shasta,2/3/2021,676,16679,210,466,0,480,11183,196,2744,480
Shasta,2/4/2021,1071,17750,663,408,0,880,11873,190,2934,880
Shasta,2/5/2021,1221,18971,163,1058,0,1032,12717,188,3122,1032
Shasta,2/6/2021,1728,20699,41,1687,0,1705,14399,23,3145,1705
Shasta,2/7/2021,26,20725,3,23,0,24,14421,2,3147,24
Shasta,2/8/2021,540,21265,167,373,0,303,14487,237,3384,303
Shasta,2/9/2021,1026,22291,651,375,0,676,14813,350,3734,676
Shasta,2/10/2021,1085,23376,782,303,0,595,14918,491,4225,596
Shasta,2/11/2021,784,24160,186,598,0,303,14745,476,4701,303
Shasta,2/12/2021,1662,25822,1141,521,0,1168,15419,494,5195,1168
Shasta,2/13/2021,1383,27205,367,1016,0,571,15177,813,6008,571
Shasta,2/14/2021,149,27354,4,145,0,125,15278,24,6032,125
Shasta,2/15/2021,380,27734,90,290,0,211,15320,169,6201,211
Shasta,2/16/2021,1086,28820,515,571,0,319,14873,766,6967,319
Shasta,2/17/2021,994,29814,438,556,0,376,14631,618,7585,376
Shasta,2/18/2021,875,30689,442,433,0,428,14612,447,8032,428
Shasta,2/19/2021,1327,32016,935,392,0,859,15003,468,8500,859
Shasta,2/20/2021,802,32818,89,713,0,303,14807,499,8999,303
Shasta,2/21/2021,31,32849,2,29,0,9,14794,22,9021,9
Shasta,2/22/2021,348,33197,74,274,0,99,14645,248,9269,99
Shasta,2/23/2021,801,33998,466,335,0,216,14276,585,9854,216
Shasta,2/24/2021,884,34882,503,381,0,270,13933,613,10467,270
Shasta,2/25/2021,480,35362,159,321,0,159,13772,320,10787,159
Shasta,2/26/2021,791,36153,95,696,0,331,13645,458,11245,331
Shasta,2/27/2021,825,36978,27,798,0,186,13194,637,11882,186
Shasta,2/28/2021,176,37154,4,172,0,126,13270,50,11932,126
Shasta,3/1/2021,555,37709,59,496,0,266,13248,288,12220,266
Shasta,3/2/2021,952,38661,465,487,0,268,12834,682,12902,268
Shasta,3/3/2021,658,39319,164,494,0,241,12658,417,13319,241
Shasta,3/4/2021,1057,40376,505,552,0,648,12899,408,13727,649
Shasta,3/5/2021,988,41364,161,798,29,322,12583,667,14394,351
Shasta,3/6/2021,845,42209,386,412,47,210,12205,635,15029,257
Shasta,3/7/2021,91,42300,3,56,32,37,12220,54,15083,69
Shasta,3/8/2021,558,42858,46,373,139,145,12093,411,15494,284
Shasta,3/9/2021,624,43482,48,398,178,249,12144,375,15869,426
Shasta,3/10/2021,797,44279,256,339,202,132,11813,664,16533,333
Shasta,3/11/2021,1047,45326,173,628,246,646,12304,401,16934,892
Shasta,3/12/2021,834,46160,173,418,243,297,12306,536,17470,538
Shasta,3/13/2021,757,46917,425,232,100,474,12597,282,17752,573
Shasta,3/14/2021,365,47282,8,335,22,227,12708,138,17890,249
Shasta,3/15/2021,495,47777,34,361,100,209,12730,286,18176,308
Shasta,3/16/2021,1084,48861,145,872,67,806,13325,278,18454,873
Shasta,3/17/2021,688,49549,190,440,58,389,13479,293,18747,447
Shasta,3/18/2021,1073,50622,236,734,103,799,14111,270,19017,902
Shasta,3/19/2021,630,51252,197,378,55,398,14333,231,19248,453
Shasta,3/20/2021,747,51999,490,243,14,599,14798,148,19396,613
Shasta,3/21/2021,312,52311,297,4,11,286,15069,26,19422,297
Shasta,3/22/2021,343,52654,37,276,30,201,15159,141,19563,231
Shasta,3/23/2021,816,53470,158,600,58,625,15656,186,19749,683
Shasta,3/24/2021,518,53988,156,325,37,359,15894,158,19907,396
Shasta,3/25/2021,780,54768,194,569,17,637,16407,141,20048,654
Shasta,3/26/2021,691,55459,261,400,30,337,16421,354,20402,368
Shasta,3/27/2021,1557,57016,405,316,836,572,16843,983,21385,1405
Shasta,3/28/2021,404,57420,299,95,10,302,17055,100,21485,312
Shasta,3/29/2021,416,57836,41,363,12,162,16976,253,21738,174
Shasta,3/30/2021,528,58364,186,335,7,321,17100,204,21942,328
Shasta,3/31/2021,622,58986,208,409,5,389,17266,228,22170,394
Shasta,4/1/2021,779,59765,245,527,7,553,17600,226,22396,560
Shasta,4/2/2021,748,60513,202,494,52,413,17733,332,22728,465
Shasta,4/3/2021,518,61031,366,133,19,395,18024,123,22851,414
Shasta,4/4/2021,292,61323,178,94,20,218,18188,74,22925,238
Shasta,4/5/2021,439,61762,67,309,63,266,18344,173,23098,329
Shasta,4/6/2021,719,62481,171,377,171,277,18351,440,23538,447
Shasta,4/7/2021,649,63130,211,275,163,260,18390,384,23922,423
Shasta,4/8/2021,1053,64183,260,640,153,231,17954,820,24742,384
Shasta,4/9/2021,2576,66759,2060,307,209,2025,19639,547,25289,2232
Shasta,4/10/2021,876,67635,594,154,128,264,19419,612,25901,392
Shasta,4/11/2021,450,68085,396,34,20,141,19274,306,26207,161
Shasta,4/12/2021,321,68406,8,253,60,88,19189,232,26439,147
Shasta,4/13/2021,979,69385,162,816,1,231,18674,747,27186,232
Shasta,4/14/2021,596,69981,143,451,2,219,18519,376,27562,221
Shasta,4/15/2021,978,70959,258,720,0,292,18127,684,28246,292
Shasta,4/16/2021,1261,72220,769,492,0,847,18560,414,28660,847
Shasta,4/17/2021,641,72861,410,231,0,198,18315,443,29103,198
Shasta,4/18/2021,266,73127,241,25,0,33,18117,231,29334,33
Shasta,4/19/2021,379,73506,31,348,0,162,18062,217,29551,162
Shasta,4/20/2021,917,74423,257,660,0,293,17732,623,30174,293
Shasta,4/21/2021,534,74957,214,320,0,277,17752,257,30431,277
Shasta,4/22/2021,796,75753,283,513,0,267,17491,528,30959,267
Shasta,4/23/2021,275,76028,116,159,0,152,17520,123,31082,152
Sierra,12/18/2020,1,1,1,0,0,1,1,0,0,1
Sierra,12/21/2020,2,3,2,0,0,2,3,0,0,2
Sierra,12/22/2020,12,15,12,0,0,12,15,0,0,12
Sierra,12/23/2020,4,19,4,0,0,4,19,0,0,4
Sierra,12/28/2020,1,20,0,1,0,1,20,0,0,1
Sierra,12/29/2020,49,69,7,42,0,49,69,0,0,49
Sierra,12/30/2020,2,71,0,2,0,2,71,0,0,2
Sierra,12/31/2020,13,84,0,13,0,13,84,0,0,13
Sierra,1/1/2021,1,85,1,0,0,1,85,0,0,1
Sierra,1/5/2021,64,149,2,62,0,64,149,0,0,64
Sierra,1/6/2021,1,150,1,0,0,1,150,0,0,1
Sierra,1/7/2021,21,171,1,20,0,20,169,1,1,20
Sierra,1/8/2021,1,172,1,0,0,1,170,0,1,1
Sierra,1/11/2021,3,175,3,0,0,0,167,3,4,0
Sierra,1/12/2021,40,215,12,28,0,28,183,12,16,28
Sierra,1/13/2021,4,219,3,1,0,1,181,3,19,1
Sierra,1/14/2021,35,254,2,33,0,35,216,0,19,35
Sierra,1/15/2021,3,257,1,2,0,3,219,0,19,3
Sierra,1/18/2021,2,259,0,2,0,2,221,0,19,2
Sierra,1/19/2021,32,291,0,32,0,32,253,0,19,32
Sierra,1/20/2021,1,292,1,0,0,1,254,0,19,1
Sierra,1/21/2021,53,345,0,53,0,53,307,0,19,53
Sierra,1/22/2021,2,347,0,2,0,2,309,0,19,2
Sierra,1/23/2021,2,349,0,2,0,2,311,0,19,2
Sierra,1/26/2021,62,411,0,62,0,24,297,38,57,24
Sierra,1/27/2021,4,415,4,0,0,0,293,4,61,0
Sierra,1/28/2021,53,468,0,53,0,43,326,10,71,43
Sierra,1/29/2021,2,470,0,2,0,2,328,0,71,2
Sierra,1/30/2021,3,473,3,0,0,2,329,1,72,2
Sierra,2/1/2021,1,474,0,1,0,0,328,1,73,0
Sierra,2/2/2021,58,532,1,57,0,19,308,39,112,19
Sierra,2/3/2021,6,538,5,1,0,5,312,1,113,5
Sierra,2/4/2021,105,643,6,99,0,56,319,49,162,56
Sierra,2/5/2021,6,649,4,2,0,5,323,1,163,5
Sierra,2/9/2021,51,700,0,51,0,48,368,3,166,48
Sierra,2/10/2021,5,705,2,3,0,4,371,1,167,4
Sierra,2/11/2021,196,901,1,195,0,134,443,62,229,134
Sierra,2/12/2021,21,922,0,21,0,20,462,1,230,20
Sierra,2/13/2021,1,923,1,0,0,1,463,0,230,1
Sierra,2/14/2021,1,924,0,1,0,1,464,0,230,1
Sierra,2/15/2021,2,926,2,0,0,0,462,2,232,0
Sierra,2/16/2021,43,969,0,43,0,10,439,33,265,10
Sierra,2/17/2021,4,973,0,4,0,1,437,3,268,1
Sierra,2/18/2021,141,1114,0,141,0,91,478,50,318,91
Sierra,2/19/2021,2,1116,1,1,0,1,478,1,319,1
Sierra,2/20/2021,2,1118,2,0,0,0,476,2,321,0
Sierra,2/22/2021,1,1119,1,0,0,1,477,0,321,1
Sierra,2/23/2021,4,1123,0,4,0,4,481,0,321,4
Sierra,2/24/2021,4,1127,3,1,0,3,483,1,322,3
Sierra,2/25/2021,125,1252,2,123,0,58,475,66,388,58
Sierra,2/26/2021,11,1263,6,5,0,4,472,7,395,4
Sierra,2/27/2021,2,1265,2,0,0,0,470,2,397,0
Sierra,3/1/2021,2,1267,2,0,0,0,468,2,399,0
Sierra,3/2/2021,56,1323,0,56,0,38,488,18,417,38
Sierra,3/3/2021,2,1325,2,0,0,1,488,1,418,1
Sierra,3/4/2021,108,1433,0,108,0,58,496,50,468,58
Sierra,3/5/2021,13,1446,1,12,0,11,505,2,470,11
Sierra,3/7/2021,1,1447,1,0,0,0,504,1,471,0
Sierra,3/8/2021,2,1449,2,0,0,2,506,0,471,2
Sierra,3/9/2021,56,1505,0,56,0,12,474,44,515,12
Sierra,3/10/2021,6,1511,0,6,0,4,476,2,517,4
Sierra,3/11/2021,175,1686,0,175,0,43,388,131,648,43
Sierra,3/12/2021,20,1706,1,19,0,0,368,20,668,0
Sierra,3/13/2021,28,1734,0,28,0,28,396,0,668,28
Sierra,3/14/2021,1,1735,0,0,1,0,396,1,669,1
Sierra,3/15/2021,2,1737,1,1,0,0,394,2,671,0
Sierra,3/16/2021,36,1773,0,35,1,23,405,13,684,24
Sierra,3/17/2021,4,1777,3,1,0,1,403,3,687,1
Sierra,3/18/2021,158,1935,0,158,0,65,375,93,780,65
Sierra,3/19/2021,4,1939,2,2,0,1,373,3,783,1
Sierra,3/20/2021,1,1940,0,1,0,1,374,0,783,1
Sierra,3/23/2021,22,1962,0,22,0,13,378,9,792,13
Sierra,3/24/2021,3,1965,1,2,0,1,377,2,794,1
Sierra,3/25/2021,100,2065,1,99,0,51,379,49,843,51
Sierra,3/26/2021,12,2077,1,11,0,9,385,3,846,9
Sierra,3/27/2021,2,2079,1,1,0,0,383,2,848,0
Sierra,3/29/2021,1,2080,1,0,0,0,382,1,849,0
Sierra,3/30/2021,55,2135,1,54,0,22,371,33,882,22
Sierra,3/31/2021,8,2143,0,8,0,8,379,0,882,8
Sierra,4/1/2021,60,2203,2,58,0,6,331,54,936,6
Sierra,4/2/2021,3,2206,2,1,0,2,332,1,937,2
Sierra,4/5/2021,1,2207,1,0,0,1,333,0,937,1
Sierra,4/6/2021,10,2217,0,10,0,0,323,10,947,0
Sierra,4/7/2021,15,2232,3,6,6,3,321,11,958,9
Sierra,4/8/2021,54,2286,2,52,0,17,301,37,995,17
Sierra,4/9/2021,2,2288,2,0,0,1,301,1,996,1
Sierra,4/10/2021,27,2315,0,27,0,0,274,27,1023,0
Sierra,4/13/2021,46,2361,0,46,0,5,238,41,1064,5
Sierra,4/14/2021,2,2363,1,1,0,2,240,0,1064,2
Sierra,4/15/2021,49,2412,1,48,0,2,195,47,1111,2
Sierra,4/16/2021,1,2413,0,1,0,1,196,0,1111,1
Sierra,4/17/2021,2,2415,1,1,0,1,196,1,1112,1
Sierra,4/19/2021,1,2416,1,0,0,0,195,1,1113,0
Sierra,4/20/2021,34,2450,1,33,0,7,175,27,1140,7
Sierra,4/21/2021,2,2452,1,1,0,1,175,1,1141,1
Sierra,4/22/2021,62,2514,0,62,0,3,120,58,1199,3
Sierra,4/23/2021,11,2525,0,11,0,3,115,8,1207,3
Siskiyou,12/16/2020,2,2,2,0,0,2,2,0,0,2
Siskiyou,12/17/2020,4,6,4,0,0,4,6,0,0,4
Siskiyou,12/18/2020,2,8,2,0,0,2,8,0,0,2
Siskiyou,12/19/2020,4,12,4,0,0,4,12,0,0,4
Siskiyou,12/20/2020,1,13,1,0,0,1,13,0,0,1
Siskiyou,12/21/2020,132,145,132,0,0,132,145,0,0,132
Siskiyou,12/22/2020,159,304,159,0,0,159,304,0,0,159
Siskiyou,12/23/2020,142,446,142,0,0,142,446,0,0,142
Siskiyou,12/24/2020,5,451,5,0,0,5,451,0,0,5
Siskiyou,12/26/2020,2,453,0,2,0,2,453,0,0,2
Siskiyou,12/27/2020,2,455,0,2,0,2,455,0,0,2
Siskiyou,12/28/2020,3,458,1,2,0,3,458,0,0,3
Siskiyou,12/29/2020,6,464,2,4,0,6,464,0,0,6
Siskiyou,12/30/2020,98,562,3,95,0,98,562,0,0,98
Siskiyou,12/31/2020,12,574,0,12,0,12,574,0,0,12
Siskiyou,1/2/2021,1,575,1,0,0,1,575,0,0,1
Siskiyou,1/3/2021,1,576,0,1,0,1,576,0,0,1
Siskiyou,1/4/2021,130,706,3,127,0,130,706,0,0,130
Siskiyou,1/5/2021,117,823,4,113,0,116,821,1,1,116
Siskiyou,1/6/2021,59,882,6,53,0,55,872,4,5,55
Siskiyou,1/7/2021,177,1059,4,173,0,176,1047,1,6,176
Siskiyou,1/8/2021,41,1100,3,38,0,39,1084,2,8,39
Siskiyou,1/9/2021,2,1102,2,0,0,0,1082,2,10,0
Siskiyou,1/11/2021,226,1328,65,161,0,163,1182,63,73,163
Siskiyou,1/12/2021,322,1650,274,48,0,88,1037,234,307,89
Siskiyou,1/13/2021,157,1807,137,20,0,23,926,134,441,23
Siskiyou,1/14/2021,26,1833,1,25,0,25,950,1,442,25
Siskiyou,1/15/2021,35,1868,3,32,0,35,985,0,442,35
Siskiyou,1/16/2021,7,1875,2,5,0,7,992,0,442,7
Siskiyou,1/17/2021,1,1876,1,0,0,0,991,1,443,0
Siskiyou,1/18/2021,76,1952,4,72,0,74,1063,2,445,74
Siskiyou,1/19/2021,21,1973,1,20,0,20,1082,1,446,20
Siskiyou,1/20/2021,47,2020,35,12,0,43,1121,4,450,43
Siskiyou,1/21/2021,42,2062,1,41,0,42,1163,0,450,42
Siskiyou,1/22/2021,1329,3391,1177,152,0,1329,2492,0,450,1329
Siskiyou,1/23/2021,5,3396,1,4,0,2,2491,3,453,2
Siskiyou,1/25/2021,182,3578,8,174,0,178,2665,4,457,178
Siskiyou,1/26/2021,148,3726,3,145,0,140,2797,8,465,140
Siskiyou,1/27/2021,181,3907,1,180,0,126,2868,55,520,126
Siskiyou,1/28/2021,232,4139,118,114,0,226,3088,6,526,226
Siskiyou,1/29/2021,248,4387,2,246,0,246,3332,2,528,246
Siskiyou,1/30/2021,3,4390,2,1,0,3,3335,0,528,3
Siskiyou,2/1/2021,195,4585,3,192,0,105,3350,90,618,105
Siskiyou,2/2/2021,289,4874,45,244,0,147,3355,142,760,147
Siskiyou,2/3/2021,313,5187,1,312,0,264,3570,49,809,264
Siskiyou,2/4/2021,320,5507,7,313,0,200,3650,120,929,200
Siskiyou,2/5/2021,512,6019,4,508,0,347,3832,165,1094,347
Siskiyou,2/6/2021,15,6034,0,15,0,15,3847,0,1094,15
Siskiyou,2/7/2021,3,6037,2,1,0,3,3850,0,1094,3
Siskiyou,2/8/2021,221,6258,5,216,0,216,4061,5,1099,216
Siskiyou,2/9/2021,195,6453,3,192,0,162,4190,33,1132,162
Siskiyou,2/10/2021,370,6823,40,330,0,316,4453,53,1185,316
Siskiyou,2/11/2021,191,7014,1,190,0,175,4612,16,1201,175
Siskiyou,2/12/2021,1692,8706,1200,492,0,501,3922,1191,2392,501
Siskiyou,2/13/2021,36,8742,2,34,0,32,3950,4,2396,32
Siskiyou,2/14/2021,5,8747,1,4,0,5,3955,0,2396,5
Siskiyou,2/15/2021,107,8854,10,97,0,105,4058,2,2398,105
Siskiyou,2/16/2021,114,8968,2,112,0,99,4142,15,2413,99
Siskiyou,2/17/2021,184,9152,15,169,0,170,4298,14,2427,170
Siskiyou,2/18/2021,221,9373,89,132,0,98,4273,123,2550,98
Siskiyou,2/19/2021,70,9443,33,37,0,34,4271,36,2586,34
Siskiyou,2/20/2021,21,9464,3,18,0,17,4284,4,2590,17
Siskiyou,2/21/2021,1,9465,1,0,0,1,4285,0,2590,1
Siskiyou,2/22/2021,124,9589,1,123,0,18,4197,106,2696,18
Siskiyou,2/23/2021,195,9784,15,180,0,51,4104,144,2840,51
Siskiyou,2/24/2021,147,9931,4,143,0,35,4027,112,2952,35
Siskiyou,2/25/2021,300,10231,24,276,0,154,4035,146,3098,154
Siskiyou,2/26/2021,667,10898,9,658,0,365,4098,302,3400,365
Siskiyou,2/27/2021,33,10931,5,28,0,28,4121,5,3405,28
Siskiyou,2/28/2021,5,10936,4,1,0,4,4124,1,3406,4
Siskiyou,3/1/2021,280,11216,6,274,0,50,3944,230,3636,50
Siskiyou,3/2/2021,190,11406,1,189,0,70,3894,120,3756,70
Siskiyou,3/3/2021,343,11749,7,336,0,153,3857,190,3946,153
Siskiyou,3/4/2021,771,12520,599,172,0,620,4326,151,4097,620
Siskiyou,3/5/2021,322,12842,6,305,11,102,4222,217,4314,113
Siskiyou,3/6/2021,36,12878,2,27,7,26,4245,10,4324,33
Siskiyou,3/7/2021,12,12890,4,0,8,3,4247,9,4333,11
Siskiyou,3/8/2021,361,13251,31,295,35,59,4039,302,4635,94
Siskiyou,3/9/2021,162,13413,0,109,53,56,4042,106,4741,109
Siskiyou,3/10/2021,221,13634,7,184,30,31,3913,190,4931,61
Siskiyou,3/11/2021,469,14103,203,219,47,270,4032,198,5129,317
Siskiyou,3/12/2021,637,14740,132,466,39,183,3802,452,5581,222
Siskiyou,3/13/2021,428,15168,381,24,23,382,4161,46,5627,405
Siskiyou,3/14/2021,21,15189,1,4,16,3,4162,18,5645,19
Siskiyou,3/15/2021,453,15642,257,176,20,321,4371,132,5777,341
Siskiyou,3/16/2021,255,15897,32,206,17,140,4414,114,5891,157
Siskiyou,3/17/2021,200,16097,8,184,8,33,4288,167,6058,41
Siskiyou,3/18/2021,925,17022,787,126,12,809,4993,116,6174,821
Siskiyou,3/19/2021,66,17088,9,44,13,20,4980,46,6220,33
Siskiyou,3/20/2021,30,17118,7,18,5,6,4967,24,6244,11
Siskiyou,3/21/2021,10,17128,4,1,5,4,4970,6,6250,9
Siskiyou,3/22/2021,207,17335,21,164,22,144,5076,60,6310,166
Siskiyou,3/23/2021,195,17530,19,166,10,141,5173,54,6364,151
Siskiyou,3/24/2021,141,17671,48,93,0,116,5264,25,6389,116
Siskiyou,3/25/2021,568,18239,318,247,3,398,5495,170,6559,401
Siskiyou,3/26/2021,294,18533,27,267,0,95,5393,197,6756,95
Siskiyou,3/27/2021,37,18570,4,28,5,9,5379,28,6784,14
Siskiyou,3/28/2021,7,18577,7,0,0,4,5380,3,6787,4
Siskiyou,3/29/2021,98,18675,11,85,2,47,5379,50,6837,49
Siskiyou,3/30/2021,98,18773,3,94,1,38,5358,60,6897,39
Siskiyou,3/31/2021,189,18962,22,165,2,50,5273,138,7035,53
Siskiyou,4/1/2021,824,19786,668,156,0,216,4881,608,7643,216
Siskiyou,4/2/2021,343,20129,196,143,4,64,4671,278,7921,68
Siskiyou,4/3/2021,25,20154,4,14,7,5,4663,20,7941,12
Siskiyou,4/4/2021,2,20156,2,0,0,1,4663,1,7942,1
Siskiyou,4/5/2021,436,20592,330,79,27,24,4303,411,8353,51
Siskiyou,4/6/2021,215,20807,32,130,53,122,4385,92,8445,174
Siskiyou,4/7/2021,115,20922,10,63,42,66,4444,49,8494,108
Siskiyou,4/8/2021,346,21268,183,122,41,60,4259,286,8780,101
Siskiyou,4/9/2021,543,21811,377,129,37,84,3923,458,9238,122
Siskiyou,4/10/2021,45,21856,6,2,37,6,3927,39,9277,43
Siskiyou,4/11/2021,7,21863,5,0,2,2,3926,5,9282,4
Siskiyou,4/12/2021,129,21992,25,103,1,49,3896,80,9362,50
Siskiyou,4/13/2021,204,22196,36,167,1,78,3849,126,9488,79
Siskiyou,4/14/2021,158,22354,66,92,0,86,3865,70,9558,86
Siskiyou,4/15/2021,1115,23469,955,160,0,437,3624,678,10236,437
Siskiyou,4/16/2021,280,23749,190,90,0,257,3859,22,10258,257
Siskiyou,4/17/2021,11,23760,8,3,0,8,3864,3,10261,8
Siskiyou,4/18/2021,5,23765,3,2,0,2,3863,3,10264,2
Siskiyou,4/19/2021,125,23890,22,103,0,43,3824,82,10346,43
Siskiyou,4/20/2021,238,24128,4,234,0,95,3776,143,10489,95
Siskiyou,4/21/2021,90,24218,12,78,0,24,3734,66,10555,24
Siskiyou,4/22/2021,410,24628,299,111,0,49,3422,361,10916,49
Siskiyou,4/23/2021,81,24709,11,70,0,77,3496,3,10919,77
Solano,12/15/2020,4,4,4,0,0,4,4,0,0,4
Solano,12/16/2020,71,75,71,0,0,71,75,0,0,71
Solano,12/17/2020,152,227,152,0,0,152,227,0,0,152
Solano,12/18/2020,445,672,444,1,0,445,672,0,0,445
Solano,12/19/2020,516,1188,516,0,0,516,1188,0,0,516
Solano,12/20/2020,353,1541,352,1,0,353,1541,0,0,353
Solano,12/21/2020,573,2114,571,2,0,573,2114,0,0,573
Solano,12/22/2020,662,2776,629,33,0,662,2776,0,0,662
Solano,12/23/2020,858,3634,772,86,0,857,3633,0,0,857
Solano,12/24/2020,421,4055,170,251,0,421,4054,0,0,421
Solano,12/25/2020,10,4065,2,8,0,10,4064,0,0,10
Solano,12/26/2020,175,4240,48,127,0,175,4239,0,0,175
Solano,12/27/2020,104,4344,29,75,0,104,4343,0,0,104
Solano,12/28/2020,863,5207,421,442,0,863,5206,0,0,863
Solano,12/29/2020,891,6098,374,517,0,891,6097,0,0,891
Solano,12/30/2020,1210,7308,599,611,0,1210,7307,0,0,1210
Solano,12/31/2020,534,7842,135,399,0,534,7841,0,0,534
Solano,1/1/2021,13,7855,12,1,0,13,7854,0,0,13
Solano,1/2/2021,212,8067,164,48,0,212,8066,0,0,212
Solano,1/3/2021,58,8125,41,17,0,53,8119,0,0,53
Solano,1/4/2021,449,8574,245,204,0,439,8555,3,3,439
Solano,1/5/2021,695,9269,377,318,0,541,8947,149,152,541
Solano,1/6/2021,822,10091,436,386,0,560,9247,260,412,560
Solano,1/7/2021,1055,11146,683,372,0,599,9393,454,866,600
Solano,1/8/2021,1129,12275,774,355,0,537,9358,574,1440,539
Solano,1/9/2021,885,13160,763,122,0,428,9332,454,1894,428
Solano,1/10/2021,254,13414,194,60,0,153,9384,101,1995,153
Solano,1/11/2021,1326,14740,1116,210,0,810,9678,516,2511,810
Solano,1/12/2021,1560,16300,1164,396,0,1012,10144,547,3058,1013
Solano,1/13/2021,1461,17761,1004,457,0,1201,11087,258,3316,1201
Solano,1/14/2021,1869,19630,798,1071,0,1555,12328,314,3630,1555
Solano,1/15/2021,1684,21314,1054,630,0,1386,13416,298,3928,1386
Solano,1/16/2021,1289,22603,903,386,0,1114,14355,175,4103,1114
Solano,1/17/2021,1041,23644,760,281,0,1024,15362,17,4120,1024
Solano,1/18/2021,1407,25051,857,550,0,1288,16533,119,4239,1290
Solano,1/19/2021,1641,26692,1336,305,0,1370,17633,270,4509,1370
Solano,1/20/2021,2027,28719,1417,610,0,1544,18697,480,4989,1544
Solano,1/21/2021,3144,31863,999,2145,0,2801,21156,343,5332,2802
Solano,1/22/2021,1750,33613,842,908,0,1560,22526,190,5522,1560
Solano,1/23/2021,732,34345,238,494,0,529,22852,204,5726,530
Solano,1/24/2021,401,34746,60,341,0,335,23121,66,5792,335
Solano,1/25/2021,1635,36381,622,1013,0,1086,23659,549,6341,1087
Solano,1/26/2021,1770,38151,736,1034,0,1140,24171,629,6970,1141
Solano,1/27/2021,1770,39921,726,1044,0,1177,24768,580,7550,1177
Solano,1/28/2021,1898,41819,702,1196,0,1308,25488,589,8139,1309
Solano,1/29/2021,1696,43515,782,914,0,1344,26482,350,8489,1344
Solano,1/30/2021,710,44225,220,490,0,549,26870,161,8650,549
Solano,1/31/2021,486,44711,394,92,0,231,26847,255,8905,232
Solano,2/1/2021,1498,46209,979,519,0,760,26871,736,9641,760
Solano,2/2/2021,3317,49526,1111,2206,0,2521,28600,792,10433,2521
Solano,2/3/2021,2241,51767,1303,938,0,1163,28689,1074,11507,1163
Solano,2/4/2021,1761,53528,907,854,0,1049,29031,707,12214,1049
Solano,2/5/2021,3063,56591,1406,1657,0,2072,30121,982,13196,2072
Solano,2/6/2021,3044,59635,1169,1875,0,2229,31538,812,14008,2229
Solano,2/7/2021,848,60483,784,64,0,232,31154,616,14624,232
Solano,2/8/2021,1712,62195,1232,480,0,681,30806,1029,15653,681
Solano,2/9/2021,1897,64092,1468,429,0,675,30260,1221,16874,675
Solano,2/10/2021,2254,66346,1496,758,0,828,29662,1426,18300,828
Solano,2/11/2021,2444,68790,1439,1005,0,1166,29560,1268,19568,1166
Solano,2/12/2021,4135,72925,1597,2538,0,2825,31082,1303,20871,2825
Solano,2/13/2021,2816,75741,243,2573,0,2431,33131,382,21253,2431
Solano,2/14/2021,690,76431,201,489,0,412,33267,276,21529,412
Solano,2/15/2021,1294,77725,323,971,0,671,33316,622,22151,671
Solano,2/16/2021,2395,80120,1230,1165,0,1629,34180,765,22916,1629
Solano,2/17/2021,2705,82825,1221,1484,0,1913,35305,789,23705,1914
Solano,2/18/2021,2587,85412,700,1887,0,809,34344,1771,25476,810
Solano,2/19/2021,2213,87625,1266,947,0,1132,34401,1077,26553,1134
Solano,2/20/2021,2544,90169,381,2163,0,2073,36002,472,27025,2073
Solano,2/21/2021,2139,92308,1860,279,0,1856,37578,280,27305,1856
Solano,2/22/2021,1576,93884,911,665,0,814,37632,761,28066,815
Solano,2/23/2021,2735,96619,1001,1734,0,1862,38624,870,28936,1862
Solano,2/24/2021,2361,98980,1132,1229,0,1331,38927,1028,29964,1331
Solano,2/25/2021,2290,101270,1347,943,0,1261,39165,1023,30987,1261
Solano,2/26/2021,2704,103974,1598,1106,0,1448,39363,1250,32237,1448
Solano,2/27/2021,3643,107617,1374,2268,1,2952,41633,683,32920,2953
Solano,2/28/2021,1353,108970,1039,314,0,1079,42441,271,33191,1079
Solano,3/1/2021,2411,111381,1051,1360,0,1809,43653,597,33788,1809
Solano,3/2/2021,1996,113377,1245,751,0,1231,44119,765,34553,1231
Solano,3/3/2021,2155,115532,1207,948,0,1344,44659,804,35357,1344
Solano,3/4/2021,4244,119776,3310,932,2,3152,46730,1086,36443,3157
Solano,3/5/2021,4827,124603,1609,3214,4,3912,49741,905,37348,3916
Solano,3/6/2021,3776,128379,825,2912,39,2599,51211,1168,38516,2638
Solano,3/7/2021,3464,131843,733,2721,10,1908,51583,1547,40063,1919
Solano,3/8/2021,1607,133450,815,521,271,1095,52439,509,40572,1365
Solano,3/9/2021,2956,136406,1341,1563,52,2121,53774,835,41407,2170
Solano,3/10/2021,2207,138613,1559,562,86,1110,53874,1093,42500,1193
Solano,3/11/2021,5655,144268,1409,3992,254,4618,57710,1036,43536,4872
Solano,3/12/2021,5768,150036,1392,4203,173,3021,58161,2743,46279,3194
Solano,3/13/2021,4571,154607,805,3682,84,2241,58165,2323,48602,2327
Solano,3/14/2021,3984,158591,3107,424,453,1651,57937,2329,50931,2101
Solano,3/15/2021,3825,162416,2272,1237,316,2447,59329,1371,52302,2763
Solano,3/16/2021,2871,165287,1141,1495,235,1441,59579,1425,53727,1675
Solano,3/17/2021,6008,171295,1483,4435,90,4656,62978,1347,55074,4746
Solano,3/18/2021,5000,176295,1675,3288,37,3693,65408,1299,56373,3729
Solano,3/19/2021,2787,179082,1877,837,73,1514,65728,1268,57641,1588
Solano,3/20/2021,5454,184536,1662,3738,54,2797,65933,2646,60287,2851
Solano,3/21/2021,1666,186202,1565,77,24,853,65997,811,61098,875
Solano,3/22/2021,2418,188620,1797,572,49,1458,66547,954,62052,1504
Solano,3/23/2021,3314,191934,1489,1783,42,1356,65991,1954,64006,1398
Solano,3/24/2021,2681,194615,1637,1010,34,1266,65882,1409,65415,1300
Solano,3/25/2021,4544,199159,3675,834,35,2003,65384,2537,67952,2039
Solano,3/26/2021,3031,202190,1917,1078,36,1622,65642,1400,69352,1658
Solano,3/27/2021,4174,206364,1147,2991,36,1796,65102,2372,71724,1832
Solano,3/28/2021,1410,207774,1100,292,18,567,64849,839,72563,586
Solano,3/29/2021,2864,210638,1496,1352,16,1485,64977,1373,73936,1501
Solano,3/30/2021,2789,213427,1824,878,87,1736,65749,1051,74987,1823
Solano,3/31/2021,2926,216353,1933,835,158,1687,66356,1236,76223,1843
Solano,4/1/2021,5081,221434,1685,3252,144,3412,68254,1658,77881,3556
Solano,4/2/2021,5938,227372,1687,4088,163,2442,67381,3477,81358,2604
Solano,4/3/2021,1510,228882,955,403,152,550,67125,958,82316,702
Solano,4/4/2021,777,229659,287,189,301,239,67131,534,82850,540
Solano,4/5/2021,2826,232485,1886,734,206,1395,67301,1430,84280,1600
Solano,4/6/2021,5358,237843,1388,3480,490,1539,65515,3815,88095,2029
Solano,4/7/2021,5047,242890,3731,923,393,2910,66687,2130,90225,3302
Solano,4/8/2021,5728,248618,1550,3322,856,1606,65039,4105,94330,2457
Solano,4/9/2021,5713,254331,1460,3487,766,1400,62909,4296,98626,2166
Solano,4/10/2021,1699,256030,944,444,311,789,63100,909,99535,1100
Solano,4/11/2021,1172,257202,741,304,127,608,63274,561,100096,735
Solano,4/12/2021,3235,260437,1661,1215,359,1489,63380,1741,101837,1847
Solano,4/13/2021,2518,262955,1089,1428,1,1315,63497,1199,103036,1316
Solano,4/14/2021,5877,268832,1737,4140,0,1848,61329,4016,107052,1848
Solano,4/15/2021,5035,273867,1838,3197,0,1616,59534,3411,110463,1616
Solano,4/16/2021,3468,277335,2390,1076,2,2242,60557,1221,111684,2244
Solano,4/17/2021,2308,279643,1053,1255,0,1034,60323,1268,112952,1034
Solano,4/18/2021,991,280634,596,395,0,528,60389,462,113414,528
Solano,4/19/2021,2031,282665,1142,889,0,1124,60613,902,114316,1126
Solano,4/20/2021,2840,285505,1681,1159,0,1669,61113,1169,115485,1669
Solano,4/21/2021,3062,288567,1921,1141,0,1625,61306,1432,116917,1625
Solano,4/22/2021,1895,290462,847,1048,0,1032,61477,861,117778,1032
Solano,4/23/2021,754,291216,257,497,0,393,61512,358,118136,393
Sonoma,12/15/2020,4,4,4,0,0,4,4,0,0,4
Sonoma,12/16/2020,27,31,27,0,0,27,31,0,0,27
Sonoma,12/17/2020,103,134,103,0,0,103,134,0,0,103
Sonoma,12/18/2020,421,555,421,0,0,421,555,0,0,421
Sonoma,12/19/2020,111,666,110,1,0,111,666,0,0,111
Sonoma,12/20/2020,174,840,174,0,0,174,840,0,0,174
Sonoma,12/21/2020,910,1750,908,2,0,909,1749,0,0,909
Sonoma,12/22/2020,1356,3106,1264,92,0,1356,3105,0,0,1356
Sonoma,12/23/2020,1605,4711,1229,376,0,1606,4711,0,0,1606
Sonoma,12/24/2020,305,5016,101,204,0,305,5016,0,0,305
Sonoma,12/25/2020,8,5024,2,6,0,8,5024,0,0,8
Sonoma,12/26/2020,266,5290,255,11,0,266,5290,0,0,266
Sonoma,12/27/2020,93,5383,80,13,0,93,5383,0,0,93
Sonoma,12/28/2020,987,6370,552,435,0,959,6342,0,0,959
Sonoma,12/29/2020,1129,7499,776,353,0,1095,7437,0,0,1095
Sonoma,12/30/2020,1093,8592,479,614,0,1085,8522,0,0,1085
Sonoma,12/31/2020,518,9110,71,447,0,519,9041,0,0,519
Sonoma,1/1/2021,10,9120,5,5,0,10,9051,0,0,10
Sonoma,1/2/2021,132,9252,126,6,0,132,9183,0,0,132
Sonoma,1/3/2021,25,9277,11,14,0,25,9208,0,0,25
Sonoma,1/4/2021,340,9617,105,235,0,339,9547,0,0,339
Sonoma,1/5/2021,437,10054,102,335,0,413,9945,15,15,413
Sonoma,1/6/2021,948,11002,434,514,0,836,10676,105,120,836
Sonoma,1/7/2021,1028,12030,535,493,0,858,11365,169,289,858
Sonoma,1/8/2021,1784,13814,1228,556,0,1313,12209,469,758,1313
Sonoma,1/9/2021,637,14451,400,237,0,589,12750,48,806,589
Sonoma,1/10/2021,472,14923,461,11,0,279,12836,193,999,279
Sonoma,1/11/2021,1381,16304,1235,146,0,413,12285,964,1963,413
Sonoma,1/12/2021,1547,17851,1294,253,0,395,11530,1150,3113,395
Sonoma,1/13/2021,2070,19921,1426,644,0,1208,11879,859,3972,1208
Sonoma,1/14/2021,1530,21451,808,722,0,1300,12949,230,4202,1300
Sonoma,1/15/2021,1563,23014,634,929,0,1343,14082,211,4413,1344
Sonoma,1/16/2021,1144,24158,615,529,0,899,14740,241,4654,899
Sonoma,1/17/2021,668,24826,548,120,0,587,15246,81,4735,587
Sonoma,1/18/2021,1105,25931,932,173,0,614,15370,491,5226,615
Sonoma,1/19/2021,2093,28024,1004,1089,0,1384,16048,707,5933,1385
Sonoma,1/20/2021,2073,30097,624,1449,0,1412,16809,652,6585,1413
Sonoma,1/21/2021,2231,32328,619,1612,0,2012,18605,217,6802,2013
Sonoma,1/22/2021,2724,35052,1034,1690,0,2576,21034,147,6949,2576
Sonoma,1/23/2021,767,35819,592,175,0,660,21588,106,7055,660
Sonoma,1/24/2021,850,36669,714,136,0,834,22406,16,7071,834
Sonoma,1/25/2021,2171,38840,520,1651,0,1684,23603,487,7558,1684
Sonoma,1/26/2021,2008,40848,295,1713,0,1552,24700,455,8013,1552
Sonoma,1/27/2021,3693,44541,1277,2416,0,3120,27252,571,8584,3123
Sonoma,1/28/2021,4112,48653,1843,2269,0,3442,30029,667,9251,3444
Sonoma,1/29/2021,2961,51614,1408,1553,0,2129,31329,830,10081,2130
Sonoma,1/30/2021,2575,54189,2387,188,0,2241,33237,334,10415,2242
Sonoma,1/31/2021,775,54964,663,112,0,577,33617,197,10612,577
Sonoma,2/1/2021,2500,57464,881,1619,0,2096,35311,402,11014,2096
Sonoma,2/2/2021,3444,60908,1366,2078,0,2879,37627,563,11577,2879
Sonoma,2/3/2021,4027,64935,1322,2705,0,3099,39800,926,12503,3099
Sonoma,2/4/2021,4190,69125,1704,2486,0,3414,42440,774,13277,3414
Sonoma,2/5/2021,4802,73927,1732,3070,0,3789,45221,1009,14286,3790
Sonoma,2/6/2021,2654,76581,2294,360,0,2096,46760,557,14843,2096
Sonoma,2/7/2021,1530,78111,1396,134,0,1280,47790,250,15093,1280
Sonoma,2/8/2021,3251,81362,1032,2219,0,2671,49882,579,15672,2671
Sonoma,2/9/2021,3551,84913,1695,1856,0,3072,52478,477,16149,3073
Sonoma,2/10/2021,4403,89316,2360,2043,0,3371,54824,1026,17175,3372
Sonoma,2/11/2021,5332,94648,2785,2547,0,4157,57808,1173,18348,4157
Sonoma,2/12/2021,5625,100273,2972,2653,0,4211,60612,1410,19758,4214
Sonoma,2/13/2021,1983,102256,1152,831,0,1205,61042,775,20533,1205
Sonoma,2/14/2021,2316,104572,1821,495,0,1570,61867,745,21278,1570
Sonoma,2/15/2021,2133,106705,787,1346,0,1605,62945,527,21805,1605
Sonoma,2/16/2021,4609,111314,2048,2561,0,3361,65062,1244,23049,3361
Sonoma,2/17/2021,5318,116632,2886,2432,0,3327,66407,1983,25032,3328
Sonoma,2/18/2021,6778,123410,2999,3779,0,3873,67383,2897,27929,3873
Sonoma,2/19/2021,5363,128773,1658,3705,0,3273,68572,2085,30014,3274
Sonoma,2/20/2021,3103,131876,2822,281,0,1223,67921,1874,31888,1223
Sonoma,2/21/2021,516,132392,412,104,0,128,67664,385,32273,128
Sonoma,2/22/2021,2714,135106,1353,1361,0,1042,67039,1667,33940,1042
Sonoma,2/23/2021,3094,138200,2067,1027,0,1351,66651,1739,35679,1351
Sonoma,2/24/2021,5448,143648,2536,2912,0,2730,66670,2713,38392,2732
Sonoma,2/25/2021,5647,149295,2226,3421,0,2973,66990,2653,41045,2973
Sonoma,2/26/2021,6015,155310,2744,3271,0,3743,68466,2267,43312,3743
Sonoma,2/27/2021,3998,159308,1902,2096,0,2663,69796,1333,44645,2663
Sonoma,2/28/2021,2329,161637,1845,484,0,612,68697,1711,46356,612
Sonoma,3/1/2021,3659,165296,1126,2533,0,1810,68668,1840,48196,1811
Sonoma,3/2/2021,4209,169505,1462,2747,0,2479,69425,1722,49918,2479
Sonoma,3/3/2021,4833,174338,2509,2324,0,2246,69091,2580,52498,2246
Sonoma,3/4/2021,5678,180016,2437,3241,0,2562,68551,3102,55600,2562
Sonoma,3/5/2021,6154,186170,2548,3591,15,2701,67828,3440,59040,2717
Sonoma,3/6/2021,2753,188923,1207,1412,134,1891,68996,856,59896,2024
Sonoma,3/7/2021,1681,190604,1393,253,35,356,68064,1323,61219,391
Sonoma,3/8/2021,3879,194483,652,3053,174,2215,68797,1654,62873,2387
Sonoma,3/9/2021,5431,199914,2999,2191,241,2681,68976,2743,65616,2922
Sonoma,3/10/2021,5927,205841,3164,2438,325,2394,68174,3520,69136,2718
Sonoma,3/11/2021,7490,213331,2974,3695,821,2649,66810,4833,73969,3469
Sonoma,3/12/2021,7386,220717,2259,3765,1362,2102,65005,5265,79234,3460
Sonoma,3/13/2021,3239,223956,1541,1462,236,1844,65688,1394,80628,2077
Sonoma,3/14/2021,1374,225330,381,852,141,847,66151,524,81152,987
Sonoma,3/15/2021,5212,230542,1496,3331,385,2191,65713,3013,84165,2575
Sonoma,3/16/2021,6261,236803,2231,3798,232,3166,66020,3090,87255,3397
Sonoma,3/17/2021,6732,243535,3519,3033,180,3535,66547,3188,90443,3715
Sonoma,3/18/2021,7096,250631,2929,3557,610,3176,66416,3914,94357,3783
Sonoma,3/19/2021,7472,258103,3227,4014,231,3317,65832,4136,98493,3552
Sonoma,3/20/2021,3629,261732,1744,1054,831,1971,66980,1651,100144,2799
Sonoma,3/21/2021,1376,263108,600,743,33,1211,68061,163,100307,1244
Sonoma,3/22/2021,4483,267591,3083,1300,100,3540,70762,940,101247,3641
Sonoma,3/23/2021,5787,273378,3598,2113,76,4664,74387,1115,102362,4740
Sonoma,3/24/2021,6583,279961,4263,2255,65,4151,76187,2415,104777,4215
Sonoma,3/25/2021,6964,286925,4189,2670,105,4337,78025,2605,107382,4443
Sonoma,3/26/2021,7255,294180,3441,3726,88,4007,78886,3234,110616,4095
Sonoma,3/27/2021,3782,297962,1498,1923,361,1124,77720,2651,113267,1485
Sonoma,3/28/2021,1502,299464,946,529,27,944,78135,556,113823,971
Sonoma,3/29/2021,2819,302283,1081,1705,33,1620,78593,1195,115018,1653
Sonoma,3/30/2021,5638,307921,3119,2457,62,3047,79116,2586,117604,3109
Sonoma,3/31/2021,5490,313411,3338,1940,212,3279,80406,2202,119806,3492
Sonoma,4/1/2021,6673,320084,3972,2368,333,3584,81242,3076,122882,3912
Sonoma,4/2/2021,5899,325983,3533,2257,109,3553,82565,2340,125222,3663
Sonoma,4/3/2021,3357,329340,1641,1497,219,1470,82379,1875,127097,1689
Sonoma,4/4/2021,1055,330395,686,279,90,667,82750,386,127483,757
Sonoma,4/5/2021,4346,334741,580,3430,336,1789,82324,2551,130034,2125
Sonoma,4/6/2021,6815,341556,3453,2963,399,3958,83836,2844,132878,4356
Sonoma,4/7/2021,6735,348291,3803,2101,831,3270,84476,3457,136335,4097
Sonoma,4/8/2021,7463,355754,4084,2613,766,4072,85932,3380,139715,4836
Sonoma,4/9/2021,6741,362495,3747,2111,883,3457,86995,3272,142987,4335
Sonoma,4/10/2021,3711,366206,1679,1479,553,1084,86009,2618,145605,1632
Sonoma,4/11/2021,1274,367480,602,591,81,434,85686,838,146443,515
Sonoma,4/12/2021,4927,372407,2050,2399,478,1852,84942,3068,149511,2324
Sonoma,4/13/2021,7775,380182,4610,3163,2,2957,83091,4810,154321,2959
Sonoma,4/14/2021,6345,386527,3590,2736,19,2504,81788,3826,158147,2523
Sonoma,4/15/2021,7045,393572,4016,3029,0,3483,81720,3551,161698,3483
Sonoma,4/16/2021,6765,400337,3400,3364,1,3843,82648,2916,164614,3844
Sonoma,4/17/2021,2967,403304,1492,1475,0,1472,82632,1489,166103,1473
Sonoma,4/18/2021,1193,404497,802,391,0,368,82178,822,166925,368
Sonoma,4/19/2021,3224,407721,1833,1391,0,1441,81838,1781,168706,1441
Sonoma,4/20/2021,6177,413898,3396,2781,0,2343,80360,3822,172528,2344
Sonoma,4/21/2021,6181,420079,4094,2085,2,2814,79820,3355,175883,2815
Sonoma,4/22/2021,5300,425379,3816,1484,0,1954,78437,3337,179220,1954
Sonoma,4/23/2021,3779,429158,2950,829,0,1926,78512,1851,181071,1926
Stanislaus,12/15/2020,3,3,3,0,0,3,3,0,0,3
Stanislaus,12/16/2020,37,40,37,0,0,37,40,0,0,37
Stanislaus,12/17/2020,73,113,73,0,0,73,113,0,0,73
Stanislaus,12/18/2020,336,449,330,6,0,336,449,0,0,336
Stanislaus,12/19/2020,133,582,133,0,0,133,582,0,0,133
Stanislaus,12/20/2020,86,668,86,0,0,86,668,0,0,86
Stanislaus,12/21/2020,996,1664,994,2,0,995,1663,0,0,995
Stanislaus,12/22/2020,797,2461,785,12,0,797,2460,0,0,797
Stanislaus,12/23/2020,446,2907,429,17,0,445,2905,0,0,445
Stanislaus,12/24/2020,97,3004,88,9,0,97,3002,0,0,97
Stanislaus,12/26/2020,50,3054,8,42,0,50,3052,0,0,50
Stanislaus,12/27/2020,11,3065,6,5,0,11,3063,0,0,11
Stanislaus,12/28/2020,490,3555,395,95,0,490,3553,0,0,490
Stanislaus,12/29/2020,493,4048,416,77,0,493,4046,0,0,493
Stanislaus,12/30/2020,535,4583,279,256,0,534,4579,1,1,534
Stanislaus,12/31/2020,276,4859,156,120,0,276,4855,0,1,276
Stanislaus,1/1/2021,11,4870,4,7,0,11,4866,0,1,11
Stanislaus,1/2/2021,31,4901,24,7,0,31,4897,0,1,31
Stanislaus,1/3/2021,89,4990,86,3,0,89,4986,0,1,89
Stanislaus,1/4/2021,111,5101,33,78,0,111,5097,0,1,111
Stanislaus,1/5/2021,832,5933,340,492,0,809,5890,22,23,815
Stanislaus,1/6/2021,948,6881,546,402,0,880,6706,65,88,881
Stanislaus,1/7/2021,1074,7955,701,373,0,959,7553,113,201,960
Stanislaus,1/8/2021,1279,9234,722,557,0,938,8157,338,539,942
Stanislaus,1/9/2021,285,9519,141,144,0,195,8262,90,629,195
Stanislaus,1/10/2021,48,9567,21,27,0,29,8272,19,648,29
Stanislaus,1/11/2021,1518,11085,1242,276,0,595,7964,917,1565,609
Stanislaus,1/12/2021,1459,12544,862,597,0,823,8162,632,2197,830
Stanislaus,1/13/2021,1415,13959,664,751,0,1101,8956,314,2511,1108
Stanislaus,1/14/2021,2213,16172,281,1932,0,2059,10919,152,2663,2115
Stanislaus,1/15/2021,2796,18968,1136,1660,0,2661,13515,131,2794,2727
Stanislaus,1/16/2021,467,19435,50,417,0,452,13955,14,2808,454
Stanislaus,1/17/2021,243,19678,201,42,0,237,14187,5,2813,237
Stanislaus,1/18/2021,2174,21852,1016,1158,0,1803,15684,366,3179,1863
Stanislaus,1/19/2021,1245,23097,719,526,0,802,16046,441,3620,803
Stanislaus,1/20/2021,995,24092,480,515,0,705,16462,289,3909,705
Stanislaus,1/21/2021,3624,27716,2935,689,0,3319,19565,303,4212,3406
Stanislaus,1/22/2021,1059,28775,308,751,0,1016,20546,39,4251,1020
Stanislaus,1/23/2021,339,29114,38,301,0,283,20778,55,4306,287
Stanislaus,1/24/2021,292,29406,100,192,0,226,20940,66,4372,228
Stanislaus,1/25/2021,3125,32531,218,2907,0,2820,23586,305,4677,2951
Stanislaus,1/26/2021,1710,34241,738,972,0,1291,24477,415,5092,1306
Stanislaus,1/27/2021,1814,36055,974,840,0,1159,24990,647,5739,1160
Stanislaus,1/28/2021,2189,38244,1496,693,0,1714,26285,467,6206,1762
Stanislaus,1/29/2021,2421,40665,1184,1237,0,1904,27759,473,6679,1947
Stanislaus,1/30/2021,284,40949,123,161,0,221,27928,52,6731,221
Stanislaus,1/31/2021,364,41313,311,53,0,350,28267,11,6742,350
Stanislaus,2/1/2021,1243,42556,544,699,0,910,28853,324,7066,910
Stanislaus,2/2/2021,1227,43783,373,854,0,774,29187,444,7510,778
Stanislaus,2/3/2021,2454,46237,1075,1379,0,1790,30322,660,8170,1795
Stanislaus,2/4/2021,2075,48312,717,1358,0,1566,31391,501,8671,1570
Stanislaus,2/5/2021,2823,51135,1453,1370,0,1591,31806,1180,9851,1595
Stanislaus,2/6/2021,875,52010,293,582,0,685,32304,188,10039,686
Stanislaus,2/7/2021,212,52222,188,24,0,42,32178,169,10208,43
Stanislaus,2/8/2021,1998,54220,1305,693,0,1094,32403,872,11080,1097
Stanislaus,2/9/2021,1820,56040,773,1047,0,1042,32686,762,11842,1045
Stanislaus,2/10/2021,1926,57966,529,1397,0,1013,32806,895,12737,1015
Stanislaus,2/11/2021,5339,63305,3244,2095,0,1224,30086,3948,16685,1228
Stanislaus,2/12/2021,3276,66581,908,2368,0,1455,29776,1766,18451,1456
Stanislaus,2/13/2021,1341,67922,648,693,0,977,30396,361,18812,981
Stanislaus,2/14/2021,420,68342,169,251,0,353,30684,65,18877,353
Stanislaus,2/15/2021,1788,70130,217,1571,0,580,30158,1111,19988,585
Stanislaus,2/16/2021,1348,71478,414,934,0,574,29966,768,20756,576
Stanislaus,2/17/2021,2719,74197,1658,1061,0,1940,31137,776,21532,1947
Stanislaus,2/18/2021,3324,77521,1876,1448,0,1792,31479,1459,22991,1801
Stanislaus,2/19/2021,2694,80215,1039,1655,0,1518,31861,1145,24136,1527
Stanislaus,2/20/2021,739,80954,372,367,0,482,32099,246,24382,484
Stanislaus,2/21/2021,871,81825,657,214,0,525,32304,331,24713,536
Stanislaus,2/22/2021,2322,84147,1675,647,0,1630,33267,669,25382,1632
Stanislaus,2/23/2021,3677,87824,679,2998,0,1736,33203,1806,27188,1742
Stanislaus,2/24/2021,4132,91956,2822,1310,0,3125,35340,992,28180,3129
Stanislaus,2/25/2021,3846,95802,2621,1225,0,3055,37624,774,28954,3058
Stanislaus,2/26/2021,4135,99937,1190,2945,0,2802,39142,1293,30247,2811
Stanislaus,2/27/2021,2058,101995,693,1364,1,1835,40778,200,30447,1836
Stanislaus,2/28/2021,797,102792,256,541,0,753,41495,37,30484,754
Stanislaus,3/1/2021,2703,105495,1581,1122,0,1592,41993,1098,31582,1596
Stanislaus,3/2/2021,2353,107848,1399,953,1,1642,42930,706,32288,1643
Stanislaus,3/3/2021,3682,111530,2212,1468,2,2884,45029,785,33073,2884
Stanislaus,3/4/2021,5369,116899,3056,2298,15,4183,48057,1166,34239,4194
Stanislaus,3/5/2021,3996,120895,1105,2875,16,3040,50171,941,35180,3055
Stanislaus,3/6/2021,3546,124441,2202,1250,94,2698,52121,844,36024,2794
Stanislaus,3/7/2021,839,125280,379,423,37,650,52625,182,36206,686
Stanislaus,3/8/2021,1964,127244,842,1034,88,1310,53378,644,36850,1397
Stanislaus,3/9/2021,2142,129386,878,1172,92,1616,54571,519,37369,1712
Stanislaus,3/10/2021,5015,134401,2466,2329,220,3711,57224,1289,38658,3942
Stanislaus,3/11/2021,5696,140097,3129,2090,477,4128,60416,1415,40073,4607
Stanislaus,3/12/2021,5725,145822,1214,2594,1917,2904,62428,2807,42880,4819
Stanislaus,3/13/2021,3336,149158,2145,1123,68,2669,64508,662,43542,2742
Stanislaus,3/14/2021,971,150129,576,344,51,481,64555,488,44030,535
Stanislaus,3/15/2021,3653,153782,1956,1348,349,1598,64545,1965,45995,1955
Stanislaus,3/16/2021,4872,158654,2430,2031,414,3514,67129,1356,47351,3940
Stanislaus,3/17/2021,4675,163329,2835,1667,173,2862,68373,1798,49149,3042
Stanislaus,3/18/2021,5383,168712,3397,1920,66,2960,69126,2279,51428,3032
Stanislaus,3/19/2021,5888,174600,1516,2850,1522,3093,70970,2771,54199,4615
Stanislaus,3/20/2021,3810,178410,2974,767,69,3343,73921,461,54660,3412
Stanislaus,3/21/2021,977,179387,877,35,65,748,74505,228,54888,812
Stanislaus,3/22/2021,2783,182170,1302,755,726,1232,74922,1539,56427,1956
Stanislaus,3/23/2021,3900,186070,2001,1641,258,2791,76890,1095,57522,3063
Stanislaus,3/24/2021,4487,190557,3184,1235,68,2616,77745,1832,59354,2687
Stanislaus,3/25/2021,4192,194749,2890,1286,16,1803,77247,2318,61672,1820
Stanislaus,3/26/2021,4660,199409,1323,3262,75,2342,77390,2287,63959,2430
Stanislaus,3/27/2021,4254,203663,2665,1563,26,1364,75919,2875,66834,1404
Stanislaus,3/28/2021,1092,204755,434,554,104,346,75643,739,67573,463
Stanislaus,3/29/2021,2921,207676,1793,1089,39,1957,76688,958,68531,2003
Stanislaus,3/30/2021,3577,211253,2020,1529,28,2174,77502,1397,69928,2211
Stanislaus,3/31/2021,5335,216588,3783,1436,116,2726,77765,2595,72523,2858
Stanislaus,4/1/2021,5590,222178,3741,1761,88,2520,77340,3058,75581,2633
Stanislaus,4/2/2021,4873,227051,1177,3549,147,2150,77015,2641,78222,2316
Stanislaus,4/3/2021,4429,231480,3200,1192,37,2152,76957,2270,80492,2212
Stanislaus,4/4/2021,1290,232770,458,803,29,636,76984,649,81141,676
Stanislaus,4/5/2021,3539,236309,2460,831,248,2289,78283,1244,82385,2543
Stanislaus,4/6/2021,5584,241893,4077,1230,277,2939,78872,2634,85019,3223
Stanislaus,4/7/2021,6207,248100,3495,2297,415,2725,78548,3469,88488,3145
Stanislaus,4/8/2021,5558,253658,3233,1896,429,2677,78794,2866,91354,3112
Stanislaus,4/9/2021,4734,258392,2040,2327,367,2132,78722,2586,93940,2514
Stanislaus,4/10/2021,6388,264780,3898,856,1634,1944,77869,4426,98366,3573
Stanislaus,4/11/2021,1497,266277,836,527,134,650,77807,846,99212,784
Stanislaus,4/12/2021,3470,269747,1995,1100,375,1837,78401,1625,100837,2219
Stanislaus,4/13/2021,5103,274850,3344,1746,13,2870,79074,2202,103039,2875
Stanislaus,4/14/2021,4566,279416,3190,1376,0,2213,78970,2322,105361,2218
Stanislaus,4/15/2021,5293,284709,3263,2028,2,3178,80071,2081,107442,3182
Stanislaus,4/16/2021,4153,288862,939,3214,0,1765,79489,2350,109792,1768
Stanislaus,4/17/2021,3080,291942,2043,1037,0,1797,80017,1274,111066,1802
Stanislaus,4/18/2021,509,292451,199,310,0,391,80297,113,111179,393
Stanislaus,4/19/2021,3398,295849,2430,968,0,1641,80222,1724,112903,1649
Stanislaus,4/20/2021,3886,299735,2369,1517,0,1731,79824,2131,115034,1733
Stanislaus,4/21/2021,3716,303451,2503,1212,1,1608,79364,2074,117108,1614
Stanislaus,4/22/2021,3781,307232,2352,1429,0,1523,78696,2220,119328,1552
Stanislaus,4/23/2021,2532,309764,337,2195,0,981,78222,1471,120799,997
Sutter,12/15/2020,1,1,1,0,0,1,1,0,0,1
Sutter,12/16/2020,4,5,4,0,0,4,5,0,0,4
Sutter,12/17/2020,2,7,2,0,0,2,7,0,0,2
Sutter,12/18/2020,20,27,20,0,0,20,27,0,0,20
Sutter,12/19/2020,44,71,44,0,0,44,71,0,0,44
Sutter,12/20/2020,42,113,42,0,0,42,113,0,0,42
Sutter,12/21/2020,100,213,100,0,0,100,213,0,0,100
Sutter,12/22/2020,172,385,172,0,0,172,385,0,0,172
Sutter,12/23/2020,116,501,111,5,0,116,501,0,0,116
Sutter,12/24/2020,17,518,11,6,0,17,518,0,0,17
Sutter,12/26/2020,39,557,35,4,0,39,557,0,0,39
Sutter,12/27/2020,24,581,23,1,0,24,581,0,0,24
Sutter,12/28/2020,83,664,55,28,0,83,664,0,0,83
Sutter,12/29/2020,101,765,14,87,0,101,765,0,0,101
Sutter,12/30/2020,136,901,34,102,0,136,901,0,0,136
Sutter,12/31/2020,70,971,6,64,0,70,971,0,0,70
Sutter,1/1/2021,3,974,3,0,0,3,974,0,0,3
Sutter,1/2/2021,133,1107,131,2,0,133,1107,0,0,133
Sutter,1/3/2021,1,1108,0,1,0,1,1108,0,0,1
Sutter,1/4/2021,248,1356,139,109,0,248,1356,0,0,248
Sutter,1/5/2021,99,1455,56,43,0,97,1451,2,2,97
Sutter,1/6/2021,205,1660,51,154,0,200,1646,5,7,200
Sutter,1/7/2021,252,1912,151,101,0,243,1881,8,15,243
Sutter,1/8/2021,147,2059,40,107,0,130,1994,17,32,130
Sutter,1/9/2021,45,2104,43,2,0,4,1957,41,73,4
Sutter,1/10/2021,394,2498,37,357,0,356,2276,37,110,356
Sutter,1/11/2021,132,2630,114,18,0,26,2196,106,216,26
Sutter,1/12/2021,201,2831,164,37,0,58,2111,143,359,58
Sutter,1/13/2021,161,2992,98,63,0,71,2093,89,448,71
Sutter,1/14/2021,144,3136,49,95,0,125,2199,19,467,125
Sutter,1/15/2021,435,3571,132,303,0,420,2604,15,482,420
Sutter,1/16/2021,386,3957,42,344,0,354,2927,31,513,354
Sutter,1/17/2021,26,3983,24,2,0,10,2921,16,529,10
Sutter,1/18/2021,116,4099,61,55,0,69,2943,47,576,69
Sutter,1/19/2021,103,4202,43,60,0,78,2996,25,601,78
Sutter,1/20/2021,255,4457,190,65,0,235,3211,20,621,235
Sutter,1/21/2021,435,4892,267,168,0,416,3608,19,640,416
Sutter,1/22/2021,268,5160,81,187,0,259,3858,9,649,259
Sutter,1/23/2021,398,5558,40,358,0,371,4202,27,676,371
Sutter,1/24/2021,17,5575,14,3,0,15,4215,2,678,15
Sutter,1/25/2021,304,5879,196,108,0,151,4214,152,830,151
Sutter,1/26/2021,243,6122,103,140,0,144,4260,98,928,144
Sutter,1/27/2021,384,6506,254,130,0,319,4514,65,993,319
Sutter,1/28/2021,525,7031,302,223,0,395,4780,129,1122,395
Sutter,1/29/2021,419,7450,146,273,0,254,4869,165,1287,254
Sutter,1/30/2021,775,8225,39,736,0,764,5622,11,1298,764
Sutter,1/31/2021,27,8252,27,0,0,27,5649,0,1298,27
Sutter,2/1/2021,164,8416,49,115,0,133,5751,31,1329,133
Sutter,2/2/2021,241,8657,26,215,0,211,5932,30,1359,211
Sutter,2/3/2021,444,9101,38,406,0,209,5906,235,1594,209
Sutter,2/4/2021,669,9770,366,303,0,620,6477,49,1643,620
Sutter,2/5/2021,286,10056,32,254,0,137,6465,149,1792,137
Sutter,2/6/2021,734,10790,28,706,0,713,7157,21,1813,713
Sutter,2/7/2021,23,10813,20,3,0,19,7172,4,1817,19
Sutter,2/8/2021,134,10947,29,105,0,98,7234,36,1853,98
Sutter,2/9/2021,245,11192,45,200,0,184,7357,61,1914,184
Sutter,2/10/2021,814,12006,379,435,0,177,6898,636,2550,177
Sutter,2/11/2021,601,12607,272,329,0,372,7041,229,2779,372
Sutter,2/12/2021,628,13235,67,561,0,311,7035,317,3096,311
Sutter,2/13/2021,898,14133,49,849,0,781,7699,117,3213,781
Sutter,2/14/2021,90,14223,25,65,0,80,7769,10,3223,80
Sutter,2/15/2021,197,14420,72,125,0,120,7812,77,3300,120
Sutter,2/16/2021,288,14708,45,243,0,205,7935,82,3382,205
Sutter,2/17/2021,826,15534,430,396,0,129,7367,697,4079,129
Sutter,2/18/2021,695,16229,50,645,0,485,7643,209,4288,485
Sutter,2/19/2021,663,16892,377,286,0,462,7906,199,4487,462
Sutter,2/20/2021,617,17509,52,565,0,513,8316,103,4590,513
Sutter,2/21/2021,29,17538,26,3,0,6,8299,23,4613,6
Sutter,2/22/2021,206,17744,122,84,0,87,8267,119,4732,87
Sutter,2/23/2021,222,17966,32,190,0,98,8241,124,4856,98
Sutter,2/24/2021,956,18922,348,608,0,189,7664,766,5622,189
Sutter,2/25/2021,774,19696,490,284,0,595,8083,176,5798,595
Sutter,2/26/2021,367,20063,59,308,0,151,8020,214,6012,151
Sutter,2/27/2021,864,20927,43,821,0,710,8574,156,6168,710
Sutter,2/28/2021,83,21010,38,45,0,65,8621,18,6186,65
Sutter,3/1/2021,246,21256,61,185,0,150,8675,96,6282,150
Sutter,3/2/2021,333,21589,56,277,0,159,8661,173,6455,159
Sutter,3/3/2021,1375,22964,504,871,0,638,8568,731,7186,638
Sutter,3/4/2021,1254,24218,866,388,0,952,9222,298,7484,952
Sutter,3/5/2021,337,24555,76,260,1,203,9293,133,7617,204
Sutter,3/6/2021,1025,25580,46,974,5,863,9999,162,7779,868
Sutter,3/7/2021,63,25643,23,39,1,43,10023,20,7799,44
Sutter,3/8/2021,225,25868,77,135,13,156,10123,69,7868,169
Sutter,3/9/2021,383,26251,133,237,13,180,10114,202,8070,193
Sutter,3/10/2021,1566,27817,679,826,61,523,9658,1040,9110,584
Sutter,3/11/2021,892,28709,439,434,19,647,10082,242,9352,666
Sutter,3/12/2021,670,29379,108,380,182,197,9989,470,9822,377
Sutter,3/13/2021,982,30361,749,216,17,782,10590,198,10020,799
Sutter,3/14/2021,126,30487,20,95,11,41,10557,85,10105,52
Sutter,3/15/2021,318,30805,66,203,49,151,10591,166,10271,200
Sutter,3/16/2021,386,31191,86,254,46,209,10669,177,10448,255
Sutter,3/17/2021,1496,32687,564,913,19,311,9822,1177,11625,330
Sutter,3/18/2021,958,33645,164,595,199,570,10203,387,12012,768
Sutter,3/19/2021,461,34106,163,269,29,282,10337,177,12189,311
Sutter,3/20/2021,954,35060,116,827,11,866,11126,88,12277,877
Sutter,3/21/2021,66,35126,46,17,3,37,11137,29,12306,40
Sutter,3/22/2021,289,35415,122,141,26,213,11300,76,12382,239
Sutter,3/23/2021,375,35790,115,228,32,252,11461,123,12505,284
Sutter,3/24/2021,1686,37476,775,841,70,318,10495,1354,13859,388
Sutter,3/25/2021,1038,38514,676,321,41,369,10238,667,14526,410
Sutter,3/26/2021,481,38995,171,293,17,292,10361,186,14712,309
Sutter,3/27/2021,936,39931,63,871,2,828,11086,105,14817,830
Sutter,3/28/2021,126,40057,71,55,0,78,11118,46,14863,78
Sutter,3/29/2021,422,40479,141,226,55,224,11201,196,15059,279
Sutter,3/30/2021,474,40953,157,307,10,317,11371,157,15216,327
Sutter,3/31/2021,1251,42204,175,1059,17,461,11068,780,15996,477
Sutter,4/1/2021,1368,43572,724,455,189,409,10715,952,16948,599
Sutter,4/2/2021,490,44062,93,295,102,200,10725,289,17237,299
Sutter,4/3/2021,912,44974,77,209,626,120,10681,790,18027,746
Sutter,4/4/2021,117,45091,22,89,6,56,10682,61,18088,62
Sutter,4/5/2021,364,45455,142,186,36,174,10705,187,18275,210
Sutter,4/6/2021,486,45941,190,240,56,257,10790,228,18503,313
Sutter,4/7/2021,1475,47416,867,534,74,615,10625,854,19357,689
Sutter,4/8/2021,1025,48441,577,340,108,563,10838,456,19813,669
Sutter,4/9/2021,555,48996,245,247,63,233,10814,320,20133,296
Sutter,4/10/2021,818,49814,105,87,626,102,10823,714,20847,723
Sutter,4/11/2021,108,49922,26,40,42,30,10817,78,20925,72
Sutter,4/12/2021,336,50258,90,192,54,136,10807,200,21125,190
Sutter,4/13/2021,426,50684,123,303,0,211,10805,213,21338,211
Sutter,4/14/2021,1292,51976,158,1133,1,214,9949,1072,22410,216
Sutter,4/15/2021,468,52444,172,296,0,180,9843,286,22696,180
Sutter,4/16/2021,384,52828,112,272,0,175,9810,208,22904,175
Sutter,4/17/2021,572,53400,82,490,0,500,10241,69,22973,500
Sutter,4/18/2021,68,53468,8,60,0,43,10260,24,22997,43
Sutter,4/19/2021,287,53755,109,178,0,121,10217,164,23161,121
Sutter,4/20/2021,387,54142,133,254,0,201,10233,185,23346,201
Sutter,4/21/2021,1236,55378,425,811,0,474,9954,753,24099,474
Sutter,4/22/2021,431,55809,146,285,0,231,9986,199,24298,231
Sutter,4/23/2021,179,55988,14,165,0,91,9992,85,24383,91
Tehama,12/15/2020,1,1,1,0,0,1,1,0,0,1
Tehama,12/16/2020,2,3,2,0,0,2,3,0,0,2
Tehama,12/17/2020,12,15,12,0,0,12,15,0,0,12
Tehama,12/18/2020,2,17,2,0,0,3,18,0,0,3
Tehama,12/21/2020,33,50,33,0,0,33,51,0,0,33
Tehama,12/22/2020,68,118,62,6,0,68,119,0,0,68
Tehama,12/23/2020,48,166,40,8,0,48,167,0,0,48
Tehama,12/24/2020,5,171,3,2,0,5,172,0,0,5
Tehama,12/26/2020,3,174,2,1,0,3,175,0,0,3
Tehama,12/27/2020,2,176,2,0,0,2,177,0,0,2
Tehama,12/28/2020,56,232,43,13,0,56,233,0,0,56
Tehama,12/29/2020,31,263,31,0,0,31,264,0,0,31
Tehama,12/30/2020,54,317,38,16,0,53,317,0,0,53
Tehama,12/31/2020,14,331,4,10,0,14,331,0,0,14
Tehama,1/1/2021,2,333,0,2,0,2,333,0,0,2
Tehama,1/4/2021,31,364,8,23,0,31,364,0,0,31
Tehama,1/5/2021,70,434,43,27,0,67,428,3,3,67
Tehama,1/6/2021,71,505,21,50,0,62,482,8,11,62
Tehama,1/7/2021,56,561,7,49,0,55,536,1,12,55
Tehama,1/8/2021,30,591,24,6,0,25,556,5,17,25
Tehama,1/9/2021,7,598,5,2,0,5,559,2,19,5
Tehama,1/10/2021,1,599,0,1,0,1,560,0,19,1
Tehama,1/11/2021,47,646,46,1,0,14,541,33,52,14
Tehama,1/12/2021,116,762,96,20,0,71,567,45,97,71
Tehama,1/13/2021,72,834,55,17,0,26,547,46,143,26
Tehama,1/14/2021,224,1058,50,174,0,222,767,2,145,222
Tehama,1/15/2021,246,1304,74,172,0,242,1005,4,149,242
Tehama,1/16/2021,272,1576,27,245,0,269,1271,3,152,269
Tehama,1/17/2021,13,1589,9,4,0,11,1280,2,154,11
Tehama,1/18/2021,10,1599,6,4,0,5,1280,5,159,5
Tehama,1/19/2021,288,1887,62,226,0,233,1458,55,214,233
Tehama,1/20/2021,301,2188,87,214,0,251,1660,49,263,251
Tehama,1/21/2021,214,2402,11,203,0,204,1854,10,273,204
Tehama,1/22/2021,214,2616,12,202,0,211,2062,3,276,211
Tehama,1/23/2021,261,2877,10,251,0,260,2321,1,277,260
Tehama,1/25/2021,31,2908,13,18,0,14,2318,17,294,14
Tehama,1/26/2021,325,3233,42,283,0,288,2569,37,331,288
Tehama,1/27/2021,299,3532,21,278,0,279,2828,20,351,279
Tehama,1/28/2021,340,3872,29,311,0,325,3138,15,366,325
Tehama,1/29/2021,321,4193,19,302,0,304,3425,17,383,304
Tehama,1/30/2021,103,4296,2,101,0,102,3526,1,384,102
Tehama,1/31/2021,1,4297,0,1,0,1,3527,0,384,1
Tehama,2/1/2021,77,4374,22,55,0,36,3522,41,425,36
Tehama,2/2/2021,343,4717,63,280,0,246,3674,94,519,246
Tehama,2/3/2021,377,5094,12,365,0,333,3963,44,563,333
Tehama,2/4/2021,466,5560,99,367,0,387,4272,79,642,388
Tehama,2/5/2021,162,5722,73,89,0,103,4316,59,701,103
Tehama,2/6/2021,28,5750,13,15,0,16,4320,12,713,16
Tehama,2/7/2021,5,5755,4,1,0,2,4319,3,716,2
Tehama,2/8/2021,35,5790,14,21,0,27,4338,8,724,27
Tehama,2/9/2021,76,5866,33,43,0,42,4346,34,758,42
Tehama,2/10/2021,233,6099,62,171,0,158,4429,75,833,158
Tehama,2/11/2021,219,6318,16,203,0,80,4372,137,970,80
Tehama,2/12/2021,355,6673,57,298,0,174,4365,181,1151,174
Tehama,2/13/2021,386,7059,13,373,0,147,4273,239,1390,147
Tehama,2/14/2021,33,7092,0,33,0,32,4304,1,1391,32
Tehama,2/15/2021,51,7143,9,42,0,45,4343,6,1397,45
Tehama,2/16/2021,240,7383,16,224,0,58,4219,182,1579,58
Tehama,2/17/2021,280,7663,12,268,0,54,4047,226,1805,54
Tehama,2/18/2021,368,8031,32,336,0,144,3967,224,2029,144
Tehama,2/19/2021,213,8244,18,195,0,42,3838,171,2200,42
Tehama,2/20/2021,271,8515,6,265,0,26,3619,245,2445,26
Tehama,2/22/2021,37,8552,13,24,0,24,3630,13,2458,24
Tehama,2/23/2021,46,8598,19,27,0,26,3636,20,2478,26
Tehama,2/24/2021,299,8897,12,287,0,26,3389,273,2751,26
Tehama,2/25/2021,377,9274,61,316,0,37,3086,340,3091,37
Tehama,2/26/2021,455,9729,19,436,0,70,2771,385,3476,70
Tehama,2/27/2021,294,10023,5,289,0,34,2545,260,3736,34
Tehama,2/28/2021,23,10046,2,21,0,20,2562,3,3739,20
Tehama,3/1/2021,63,10109,8,55,0,29,2557,34,3773,29
Tehama,3/2/2021,124,10233,17,107,0,29,2491,95,3868,29
Tehama,3/3/2021,132,10365,33,99,0,47,2453,85,3953,47
Tehama,3/4/2021,592,10957,22,570,0,218,2303,368,4321,218
Tehama,3/5/2021,384,11341,18,366,0,214,2348,169,4490,214
Tehama,3/6/2021,295,11636,17,278,0,80,2215,214,4704,81
Tehama,3/7/2021,5,11641,1,4,0,3,2217,1,4705,3
Tehama,3/8/2021,58,11699,12,31,15,27,2229,30,4735,42
Tehama,3/9/2021,359,12058,5,335,19,304,2497,55,4790,323
Tehama,3/10/2021,350,12408,12,317,21,68,2305,281,5071,89
Tehama,3/11/2021,482,12890,14,422,46,340,2549,142,5213,386
Tehama,3/12/2021,300,13190,18,217,65,176,2666,124,5337,241
Tehama,3/13/2021,45,13235,8,31,6,6,2639,39,5376,12
Tehama,3/14/2021,43,13278,3,29,11,2,2611,41,5417,13
Tehama,3/15/2021,153,13431,21,112,20,86,2650,67,5484,106
Tehama,3/16/2021,408,13839,14,356,38,309,2899,98,5582,347
Tehama,3/17/2021,423,14262,22,369,32,338,3186,83,5665,370
Tehama,3/18/2021,484,14746,25,435,24,306,3340,176,5841,330
Tehama,3/19/2021,313,15059,23,277,13,271,3582,42,5883,284
Tehama,3/20/2021,41,15100,8,31,2,29,3601,12,5895,31
Tehama,3/21/2021,12,15112,5,7,0,12,3613,0,5895,12
Tehama,3/22/2021,90,15202,7,66,17,49,3638,41,5936,66
Tehama,3/23/2021,85,15287,24,54,7,66,3692,19,5955,73
Tehama,3/24/2021,85,15372,16,66,3,55,3720,30,5985,58
Tehama,3/25/2021,514,15886,351,150,13,467,4154,46,6031,480
Tehama,3/26/2021,464,16350,356,96,12,389,4480,75,6106,401
Tehama,3/27/2021,437,16787,348,68,21,374,4813,62,6168,395
Tehama,3/28/2021,34,16821,13,21,0,22,4823,12,6180,22
Tehama,3/29/2021,121,16942,32,89,0,76,4855,44,6224,76
Tehama,3/30/2021,361,17303,212,147,2,247,4990,114,6338,249
Tehama,3/31/2021,379,17682,278,98,3,305,5225,73,6411,308
Tehama,4/1/2021,518,18200,243,269,6,387,5487,131,6542,393
Tehama,4/2/2021,442,18642,204,232,6,257,5565,185,6727,263
Tehama,4/3/2021,61,18703,3,53,5,30,5569,31,6758,35
Tehama,4/4/2021,34,18737,6,27,1,22,5580,12,6770,23
Tehama,4/5/2021,114,18851,20,68,26,59,5610,55,6825,85
Tehama,4/6/2021,480,19331,105,324,51,133,5447,347,7172,184
Tehama,4/7/2021,417,19748,279,94,44,304,5683,111,7283,347
Tehama,4/8/2021,596,20344,172,386,38,228,5582,367,7650,266
Tehama,4/9/2021,418,20762,185,201,32,208,5614,208,7858,240
Tehama,4/10/2021,73,20835,9,37,27,39,5646,34,7892,66
Tehama,4/11/2021,25,20860,7,7,11,8,5648,17,7909,19
Tehama,4/12/2021,113,20973,6,88,19,44,5642,69,7978,63
Tehama,4/13/2021,296,21269,57,239,0,62,5470,234,8212,62
Tehama,4/14/2021,462,21731,48,414,0,50,5108,412,8624,50
Tehama,4/15/2021,493,22224,192,301,0,84,4783,409,9033,84
Tehama,4/16/2021,564,22788,312,252,0,94,4407,470,9503,94
Tehama,4/17/2021,344,23132,266,78,0,50,4165,293,9796,51
Tehama,4/18/2021,16,23148,2,14,0,12,4173,4,9800,12
Tehama,4/19/2021,93,23241,7,86,0,41,4162,52,9852,41
Tehama,4/20/2021,499,23740,412,87,0,149,3965,348,10200,151
Tehama,4/21/2021,502,24242,438,64,0,182,3827,320,10520,182
Tehama,4/22/2021,500,24742,356,144,0,146,3620,353,10873,146
Tehama,4/23/2021,397,25139,326,71,0,176,3576,221,11094,177
Trinity,12/17/2020,4,4,4,0,0,4,4,0,0,4
Trinity,12/18/2020,2,6,2,0,0,2,6,0,0,2
Trinity,12/21/2020,38,44,38,0,0,38,44,0,0,38
Trinity,12/22/2020,5,49,5,0,0,5,49,0,0,5
Trinity,12/23/2020,5,54,5,0,0,5,54,0,0,5
Trinity,12/28/2020,30,84,30,0,0,30,84,0,0,30
Trinity,12/29/2020,8,92,7,1,0,8,92,0,0,8
Trinity,12/30/2020,10,102,8,2,0,10,102,0,0,10
Trinity,12/31/2020,2,104,1,1,0,2,104,0,0,2
Trinity,1/4/2021,27,131,0,27,0,26,130,0,0,26
Trinity,1/5/2021,2,133,1,1,0,2,132,0,0,2
Trinity,1/6/2021,23,156,4,19,0,19,147,4,4,19
Trinity,1/8/2021,49,205,2,47,0,48,193,2,6,48
Trinity,1/11/2021,39,244,38,1,0,2,158,37,43,2
Trinity,1/12/2021,9,253,7,2,0,4,157,5,48,4
Trinity,1/13/2021,7,260,4,3,0,4,158,3,51,4
Trinity,1/14/2021,3,263,1,2,0,3,161,0,51,3
Trinity,1/16/2021,4,267,0,4,0,4,165,0,51,4
Trinity,1/18/2021,31,298,31,0,0,1,136,30,81,1
Trinity,1/19/2021,95,393,14,81,0,81,203,14,95,81
Trinity,1/20/2021,19,412,3,16,0,17,218,2,97,17
Trinity,1/21/2021,17,429,7,10,0,17,235,0,97,17
Trinity,1/22/2021,5,434,1,4,0,5,240,0,97,5
Trinity,1/23/2021,7,441,3,4,0,7,247,0,97,7
Trinity,1/25/2021,14,455,1,13,0,13,259,1,98,13
Trinity,1/26/2021,10,465,1,9,0,9,267,1,99,9
Trinity,1/27/2021,12,477,0,12,0,12,279,0,99,12
Trinity,1/28/2021,13,490,3,10,0,10,286,3,102,10
Trinity,1/29/2021,3,493,1,2,0,2,287,1,103,2
Trinity,1/30/2021,12,505,11,1,0,12,299,0,103,12
Trinity,2/1/2021,2,507,1,1,0,1,299,1,104,1
Trinity,2/2/2021,13,520,3,10,0,13,312,0,104,13
Trinity,2/3/2021,6,526,1,5,0,3,312,3,107,3
Trinity,2/4/2021,36,562,32,4,0,34,344,2,109,34
Trinity,2/5/2021,348,910,0,348,0,318,632,30,139,318
Trinity,2/6/2021,209,1119,5,204,0,202,827,7,146,202
Trinity,2/7/2021,1,1120,0,1,0,1,828,0,146,1
Trinity,2/8/2021,23,1143,0,23,0,15,835,8,154,15
Trinity,2/9/2021,21,1164,2,19,0,6,826,15,169,6
Trinity,2/10/2021,123,1287,10,113,0,103,909,20,189,103
Trinity,2/11/2021,335,1622,2,333,0,329,1232,6,195,329
Trinity,2/12/2021,9,1631,6,3,0,9,1241,0,195,9
Trinity,2/13/2021,12,1643,5,7,0,5,1239,7,202,5
Trinity,2/14/2021,2,1645,2,0,0,2,1241,0,202,2
Trinity,2/15/2021,46,1691,0,46,0,46,1287,0,202,46
Trinity,2/16/2021,7,1698,2,5,0,4,1288,3,205,4
Trinity,2/17/2021,94,1792,2,92,0,84,1362,10,215,84
Trinity,2/18/2021,4,1796,0,4,0,1,1360,3,218,1
Trinity,2/19/2021,209,2005,2,207,0,196,1543,13,231,196
Trinity,2/20/2021,141,2146,14,127,0,113,1628,28,259,113
Trinity,2/22/2021,3,2149,0,3,0,0,1625,3,262,0
Trinity,2/23/2021,8,2157,4,4,0,3,1623,5,267,3
Trinity,2/24/2021,30,2187,8,22,0,7,1607,23,290,7
Trinity,2/25/2021,36,2223,23,13,0,5,1581,31,321,5
Trinity,2/26/2021,11,2234,1,10,0,5,1580,6,327,5
Trinity,2/27/2021,9,2243,7,2,0,4,1579,5,332,4
Trinity,3/1/2021,8,2251,0,8,0,5,1581,3,335,5
Trinity,3/2/2021,8,2259,3,5,0,1,1575,7,342,1
Trinity,3/3/2021,5,2264,0,5,0,4,1578,1,343,4
Trinity,3/4/2021,15,2279,10,5,0,13,1589,2,345,13
Trinity,3/5/2021,298,2577,1,297,0,35,1365,259,604,35
Trinity,3/6/2021,196,2773,7,189,0,26,1221,170,774,26
Trinity,3/7/2021,3,2776,3,0,0,2,1222,1,775,2
Trinity,3/8/2021,3,2779,0,2,1,1,1222,2,777,2
Trinity,3/9/2021,93,2872,0,91,2,89,1309,4,781,91
Trinity,3/10/2021,127,2999,3,121,3,38,1261,89,870,41
Trinity,3/11/2021,8,3007,3,3,2,4,1263,4,874,6
Trinity,3/12/2021,337,3344,2,329,6,46,1024,291,1165,52
Trinity,3/13/2021,13,3357,8,3,2,8,1029,5,1170,10
Trinity,3/15/2021,66,3423,0,65,1,14,992,52,1222,15
Trinity,3/16/2021,115,3538,7,108,0,101,1079,14,1236,101
Trinity,3/17/2021,100,3638,3,97,0,26,1031,74,1310,26
Trinity,3/18/2021,10,3648,2,5,3,5,1034,5,1315,8
Trinity,3/19/2021,367,4015,4,253,110,33,843,334,1649,143
Trinity,3/20/2021,104,4119,7,97,0,69,877,35,1684,69
Trinity,3/21/2021,3,4122,0,2,1,2,879,1,1685,3
Trinity,3/22/2021,2,4124,0,2,0,2,881,0,1685,2
Trinity,3/23/2021,95,4219,1,94,0,78,942,17,1702,78
Trinity,3/24/2021,9,4228,1,8,0,9,951,0,1702,9
Trinity,3/25/2021,106,4334,7,93,6,83,1017,23,1725,89
Trinity,3/26/2021,15,4349,2,13,0,9,1020,6,1731,9
Trinity,3/27/2021,16,4365,4,3,9,5,1023,11,1742,14
Trinity,3/28/2021,5,4370,3,2,0,1,1020,4,1746,1
Trinity,3/29/2021,4,4374,0,4,0,1,1018,3,1749,1
Trinity,3/30/2021,75,4449,4,71,0,67,1077,8,1757,67
Trinity,3/31/2021,56,4505,5,19,32,21,1094,35,1792,52
Trinity,4/1/2021,38,4543,11,16,11,19,1105,19,1811,30
Trinity,4/2/2021,163,4706,6,83,74,69,1155,93,1904,143
Trinity,4/3/2021,19,4725,14,5,0,9,1154,10,1914,9
Trinity,4/4/2021,10,4735,8,2,0,10,1164,0,1914,10
Trinity,4/5/2021,59,4794,6,52,1,55,1216,4,1918,56
Trinity,4/6/2021,110,4904,13,94,3,22,1153,88,2006,25
Trinity,4/7/2021,21,4925,12,4,5,14,1165,7,2013,19
Trinity,4/8/2021,87,5012,10,75,2,50,1180,37,2050,52
Trinity,4/9/2021,118,5130,20,93,5,84,1235,34,2084,89
Trinity,4/10/2021,11,5141,7,4,0,10,1244,1,2085,10
Trinity,4/11/2021,8,5149,5,1,2,4,1246,4,2089,6
Trinity,4/12/2021,77,5226,5,71,1,64,1298,12,2101,64
Trinity,4/13/2021,96,5322,4,92,0,10,1222,86,2187,10
Trinity,4/14/2021,10,5332,5,5,0,6,1224,4,2191,6
Trinity,4/15/2021,43,5375,10,33,0,14,1209,29,2220,14
Trinity,4/16/2021,105,5480,7,98,0,40,1184,65,2285,40
Trinity,4/17/2021,11,5491,5,6,0,9,1191,2,2287,9
Trinity,4/18/2021,1,5492,1,0,0,0,1190,1,2288,0
Trinity,4/19/2021,3,5495,0,3,0,3,1193,0,2288,3
Trinity,4/20/2021,91,5586,8,83,0,19,1140,72,2360,19
Trinity,4/21/2021,22,5608,10,12,0,10,1138,12,2372,10
Trinity,4/22/2021,91,5699,7,84,0,15,1077,76,2448,15
Trinity,4/23/2021,108,5807,1,107,0,102,1173,6,2454,102
Tulare,12/15/2020,1,1,1,0,0,1,1,0,0,1
Tulare,12/16/2020,3,4,3,0,0,3,4,0,0,3
Tulare,12/17/2020,110,114,110,0,0,110,114,0,0,110
Tulare,12/18/2020,289,403,289,0,0,289,403,0,0,289
Tulare,12/19/2020,328,731,328,0,0,328,731,0,0,328
Tulare,12/20/2020,166,897,165,1,0,166,897,0,0,166
Tulare,12/21/2020,422,1319,422,0,0,442,1339,0,0,442
Tulare,12/22/2020,469,1788,467,2,0,468,1807,0,0,468
Tulare,12/23/2020,328,2116,320,8,0,326,2133,0,0,326
Tulare,12/24/2020,18,2134,16,2,0,18,2151,0,0,18
Tulare,12/26/2020,8,2142,7,1,0,8,2159,0,0,8
Tulare,12/27/2020,16,2158,12,4,0,16,2175,0,0,16
Tulare,12/28/2020,483,2641,471,12,0,482,2657,0,0,482
Tulare,12/29/2020,546,3187,478,68,0,546,3203,0,0,546
Tulare,12/30/2020,474,3661,435,39,0,474,3677,0,0,474
Tulare,12/31/2020,94,3755,22,72,0,94,3771,0,0,94
Tulare,1/1/2021,2,3757,1,1,0,2,3773,0,0,2
Tulare,1/2/2021,28,3785,17,11,0,28,3801,0,0,28
Tulare,1/3/2021,23,3808,9,14,0,23,3824,0,0,23
Tulare,1/4/2021,92,3900,16,76,0,92,3916,0,0,92
Tulare,1/5/2021,460,4360,278,182,0,458,4372,2,2,458
Tulare,1/6/2021,865,5225,636,229,0,855,5217,10,12,855
Tulare,1/7/2021,782,6007,584,198,0,676,5787,106,118,676
Tulare,1/8/2021,1267,7274,575,692,0,929,6379,337,455,929
Tulare,1/9/2021,742,8016,204,538,0,554,6745,188,643,554
Tulare,1/10/2021,50,8066,44,6,0,11,6717,39,682,11
Tulare,1/11/2021,1266,9332,767,499,0,831,7113,435,1117,831
Tulare,1/12/2021,1402,10734,488,914,0,995,7703,406,1523,996
Tulare,1/13/2021,458,11192,228,230,0,383,8011,75,1598,383
Tulare,1/14/2021,492,11684,141,351,0,466,8462,15,1613,466
Tulare,1/15/2021,1619,13303,151,1468,0,1610,10063,9,1622,1610
Tulare,1/16/2021,1901,15204,114,1787,0,1887,11936,14,1636,1887
Tulare,1/17/2021,141,15345,122,19,0,131,12057,10,1646,131
Tulare,1/18/2021,695,16040,662,33,0,295,11952,400,2046,295
Tulare,1/19/2021,1006,17046,683,323,0,578,12102,428,2474,578
Tulare,1/20/2021,2377,19423,564,1813,0,1991,13707,386,2860,1991
Tulare,1/21/2021,1511,20934,150,1361,0,1485,15171,21,2881,1485
Tulare,1/22/2021,1054,21988,185,869,0,1030,16178,23,2904,1030
Tulare,1/23/2021,438,22426,156,282,0,417,16574,21,2925,417
Tulare,1/24/2021,30,22456,27,3,0,28,16600,2,2927,28
Tulare,1/25/2021,1324,23780,979,345,0,1295,17866,29,2956,1295
Tulare,1/26/2021,1498,25278,1099,399,0,1173,18715,324,3280,1173
Tulare,1/27/2021,1456,26734,1070,386,0,878,19015,578,3858,878
Tulare,1/28/2021,1199,27933,768,431,0,804,19424,395,4253,804
Tulare,1/29/2021,1129,29062,719,410,0,819,19933,310,4563,819
Tulare,1/30/2021,1673,30735,1579,94,0,1649,21559,24,4587,1650
Tulare,1/31/2021,51,30786,47,4,0,48,21604,3,4590,48
Tulare,2/1/2021,1183,31969,916,267,0,831,22084,351,4941,831
Tulare,2/2/2021,676,32645,328,348,0,445,22301,229,5170,446
Tulare,2/3/2021,613,33258,287,326,0,336,22362,275,5445,336
Tulare,2/4/2021,551,33809,164,387,0,266,22344,285,5730,267
Tulare,2/5/2021,1230,35039,233,997,0,414,21944,814,6544,414
Tulare,2/6/2021,834,35873,158,676,0,266,21644,566,7110,266
Tulare,2/7/2021,78,35951,66,12,0,23,21612,55,7165,23
Tulare,2/8/2021,941,36892,327,614,0,245,21164,693,7858,245
Tulare,2/9/2021,1403,38295,326,1077,0,360,20486,1038,8896,360
Tulare,2/10/2021,2469,40764,1986,483,0,2069,22158,397,9293,2069
Tulare,2/11/2021,1322,42086,376,946,0,938,22712,384,9677,938
Tulare,2/12/2021,2776,44862,576,2200,0,1214,22371,1555,11232,1214
Tulare,2/13/2021,2479,47341,157,2322,0,666,21227,1810,13042,666
Tulare,2/14/2021,333,47674,36,297,0,300,21494,33,13075,300
Tulare,2/15/2021,915,48589,291,624,0,658,21896,256,13331,658
Tulare,2/16/2021,2831,51420,1595,1236,0,1077,21220,1753,15084,1077
Tulare,2/17/2021,2699,54119,509,2190,0,463,19452,2231,17315,463
Tulare,2/18/2021,2299,56418,456,1843,0,632,18425,1659,18974,632
Tulare,2/19/2021,2295,58713,855,1440,0,942,18016,1351,20325,942
Tulare,2/20/2021,2989,61702,1892,1097,0,1267,17566,1717,22042,1267
Tulare,2/21/2021,95,61797,91,4,0,60,17591,35,22077,60
Tulare,2/22/2021,1105,62902,701,404,0,212,16911,892,22969,212
Tulare,2/23/2021,1946,64848,940,1006,0,1457,17880,488,23457,1457
Tulare,2/24/2021,2473,67321,1549,924,0,2095,19599,377,23834,2096
Tulare,2/25/2021,3483,70804,1948,1535,0,3069,22258,410,24244,3069
Tulare,2/26/2021,3837,74641,1879,1958,0,3375,25173,460,24704,3375
Tulare,2/27/2021,2898,77539,1390,1508,0,2766,27818,121,24825,2766
Tulare,2/28/2021,1304,78843,1033,271,0,1284,29084,18,24843,1284
Tulare,3/1/2021,1737,80580,773,964,0,1553,30455,182,25025,1553
Tulare,3/2/2021,2678,83258,1191,1487,0,2513,32806,163,25188,2514
Tulare,3/3/2021,3822,87080,2507,1315,0,1875,32738,1945,27133,1877
Tulare,3/4/2021,2865,89945,1292,1573,0,2550,34976,312,27445,2550
Tulare,3/5/2021,3281,93226,1692,1574,15,2777,37270,500,27945,2794
Tulare,3/6/2021,3058,96284,1431,1568,59,2811,39894,244,28189,2868
Tulare,3/7/2021,1093,97377,683,389,21,1053,40928,40,28229,1074
Tulare,3/8/2021,1664,99041,977,519,168,1351,42136,310,28539,1518
Tulare,3/9/2021,3178,102219,2182,849,147,2783,44669,395,28934,2928
Tulare,3/10/2021,2786,105005,1384,1227,175,2407,46878,371,29305,2580
Tulare,3/11/2021,4134,109139,1960,1873,301,3199,49442,935,30240,3499
Tulare,3/12/2021,4334,113473,2377,1609,348,3066,51598,1260,31500,3416
Tulare,3/13/2021,4005,117478,1846,2054,105,3068,53840,931,32431,3173
Tulare,3/14/2021,1801,119279,973,609,219,1273,54804,527,32958,1491
Tulare,3/15/2021,2710,121989,1593,1002,115,1938,56088,770,33728,2054
Tulare,3/16/2021,3419,125408,2114,1228,77,1872,56496,1544,35272,1952
Tulare,3/17/2021,4006,129414,2604,1325,77,2265,57110,1735,37007,2349
Tulare,3/18/2021,4538,133952,3296,1171,71,2414,57478,2119,39126,2487
Tulare,3/19/2021,5054,139006,3311,1547,196,2713,58062,2327,41453,2911
Tulare,3/20/2021,4347,143353,2682,1293,372,2012,58121,2328,43781,2387
Tulare,3/21/2021,1891,145244,1619,246,26,965,58188,923,44704,990
Tulare,3/22/2021,2485,147729,1697,677,111,1666,59154,813,45517,1779
Tulare,3/23/2021,3718,151447,2137,1530,51,2078,59659,1630,47147,2135
Tulare,3/24/2021,3172,154619,1967,1163,42,1865,60266,1300,48447,1907
Tulare,3/25/2021,3401,158020,1748,1480,173,1675,60395,1721,50168,1850
Tulare,3/26/2021,5082,163102,3003,1970,109,2476,60393,2587,52755,2585
Tulare,3/27/2021,3452,166554,1766,1589,97,940,58928,2505,55260,1040
Tulare,3/28/2021,1434,167988,1035,368,31,664,58860,769,56029,701
Tulare,3/29/2021,2846,170834,1624,1110,112,1221,58574,1621,57650,1335
Tulare,3/30/2021,4585,175419,2578,1777,230,1457,57137,3121,60771,1684
Tulare,3/31/2021,3713,179132,2169,1433,111,1517,56579,2188,62959,1630
Tulare,4/1/2021,4305,183437,2321,1919,65,1502,55352,2795,65754,1568
Tulare,4/2/2021,5144,188581,2917,2110,117,1647,53636,3481,69235,1765
Tulare,4/3/2021,3436,192017,2003,1122,311,850,52248,2549,71784,1161
Tulare,4/4/2021,1618,193635,1133,478,7,392,51423,1224,73008,399
Tulare,4/5/2021,3289,196924,2311,715,263,855,50118,2424,75432,1119
Tulare,4/6/2021,3321,200245,1463,1367,491,928,49154,2389,77821,1425
Tulare,4/7/2021,3733,203978,1799,1515,419,1229,48297,2496,80317,1639
Tulare,4/8/2021,4628,208606,2586,1588,454,1522,47173,3098,83415,1974
Tulare,4/9/2021,4723,213329,2921,1389,413,1810,46491,2906,86321,2224
Tulare,4/10/2021,3785,217114,2037,1434,314,1029,45083,2749,89070,1341
Tulare,4/11/2021,1573,218687,1033,468,72,594,44773,976,90046,666
Tulare,4/12/2021,3368,222055,2104,670,594,1085,44187,2266,92312,1680
Tulare,4/13/2021,2392,224447,1578,804,10,911,43637,1473,93785,923
Tulare,4/14/2021,2802,227249,1662,1140,0,909,42655,1891,95676,909
Tulare,4/15/2021,3173,230422,2069,1104,0,1436,42363,1728,97404,1436
Tulare,4/16/2021,3606,234028,2206,1400,0,1509,41784,2088,99492,1509
Tulare,4/17/2021,2134,236162,1259,875,0,1167,41988,964,100456,1168
Tulare,4/18/2021,1502,237664,1174,328,0,823,42133,678,101134,823
Tulare,4/19/2021,2102,239766,1211,889,2,899,41832,1202,102336,901
Tulare,4/20/2021,2198,241964,1259,939,0,1002,41642,1192,103528,1002
Tulare,4/21/2021,2064,244028,1301,763,0,812,41211,1243,104771,812
Tulare,4/22/2021,2057,246085,1158,899,0,731,40625,1317,106088,731
Tulare,4/23/2021,1665,247750,1052,612,1,685,40339,971,107059,685
Tuolumne,12/16/2020,45,45,45,0,0,45,45,0,0,45
Tuolumne,12/17/2020,17,62,17,0,0,17,62,0,0,17
Tuolumne,12/18/2020,101,163,100,1,0,101,163,0,0,101
Tuolumne,12/19/2020,5,168,5,0,0,5,168,0,0,5
Tuolumne,12/20/2020,1,169,1,0,0,1,169,0,0,1
Tuolumne,12/21/2020,112,281,98,14,0,112,281,0,0,112
Tuolumne,12/22/2020,168,449,168,0,0,168,449,0,0,168
Tuolumne,12/23/2020,186,635,184,2,0,186,635,0,0,186
Tuolumne,12/26/2020,3,638,3,0,0,3,638,0,0,3
Tuolumne,12/28/2020,78,716,76,2,0,78,716,0,0,78
Tuolumne,12/29/2020,102,818,39,63,0,102,818,0,0,102
Tuolumne,12/30/2020,77,895,22,55,0,77,895,0,0,77
Tuolumne,12/31/2020,27,922,20,7,0,27,922,0,0,27
Tuolumne,1/1/2021,6,928,5,1,0,6,928,0,0,6
Tuolumne,1/2/2021,118,1046,115,3,0,118,1046,0,0,118
Tuolumne,1/3/2021,3,1049,2,1,0,3,1049,0,0,3
Tuolumne,1/4/2021,68,1117,25,43,0,68,1117,0,0,68
Tuolumne,1/5/2021,91,1208,26,65,0,89,1204,2,2,89
Tuolumne,1/6/2021,111,1319,51,60,0,68,1229,43,45,68
Tuolumne,1/7/2021,119,1438,62,57,0,64,1238,55,100,64
Tuolumne,1/8/2021,103,1541,79,24,0,26,1189,76,176,27
Tuolumne,1/9/2021,1,1542,0,1,0,1,1190,0,176,1
Tuolumne,1/10/2021,3,1545,1,2,0,3,1193,0,176,3
Tuolumne,1/11/2021,114,1659,88,26,0,33,1145,81,257,33
Tuolumne,1/12/2021,101,1760,85,16,0,17,1078,84,341,17
Tuolumne,1/13/2021,230,1990,125,105,0,181,1211,49,390,182
Tuolumne,1/14/2021,130,2120,90,40,0,43,1168,86,476,43
Tuolumne,1/15/2021,475,2595,73,402,0,412,1519,62,538,413
Tuolumne,1/16/2021,7,2602,3,4,0,6,1524,1,539,6
Tuolumne,1/17/2021,6,2608,3,3,0,5,1529,0,539,5
Tuolumne,1/18/2021,46,2654,38,8,0,9,1502,36,575,9
Tuolumne,1/19/2021,473,3127,72,401,0,428,1885,45,620,428
Tuolumne,1/20/2021,76,3203,58,18,0,24,1858,51,671,24
Tuolumne,1/21/2021,56,3259,22,34,0,41,1884,15,686,41
Tuolumne,1/22/2021,165,3424,13,152,0,159,2037,6,692,159
Tuolumne,1/23/2021,664,4088,146,518,0,551,2485,113,805,561
Tuolumne,1/24/2021,523,4611,1,522,0,519,3002,3,808,520
Tuolumne,1/25/2021,48,4659,27,21,0,22,2999,26,834,23
Tuolumne,1/26/2021,80,4739,68,12,0,40,3000,40,874,41
Tuolumne,1/27/2021,60,4799,4,56,0,7,2955,52,926,7
Tuolumne,1/28/2021,27,4826,7,20,0,18,2964,9,935,18
Tuolumne,1/29/2021,71,4897,6,65,0,33,2959,38,973,33
Tuolumne,1/30/2021,709,5606,552,157,0,687,3640,22,995,703
Tuolumne,1/31/2021,8,5614,2,6,0,5,3642,3,998,5
Tuolumne,2/1/2021,24,5638,6,18,0,21,3660,3,1001,21
Tuolumne,2/2/2021,645,6283,36,609,0,635,4286,9,1010,635
Tuolumne,2/3/2021,238,6521,108,130,0,85,4218,153,1163,85
Tuolumne,2/4/2021,125,6646,13,112,0,62,4217,63,1226,62
Tuolumne,2/5/2021,99,6745,12,87,0,36,4191,62,1288,36
Tuolumne,2/6/2021,852,7597,580,272,0,849,5037,3,1291,849
Tuolumne,2/7/2021,7,7604,4,3,0,3,5036,4,1295,3
Tuolumne,2/8/2021,91,7695,40,51,0,67,5079,24,1319,67
Tuolumne,2/9/2021,865,8560,52,813,0,827,5868,38,1357,827
Tuolumne,2/10/2021,87,8647,15,72,0,27,5836,59,1416,27
Tuolumne,2/11/2021,142,8789,66,76,0,75,5844,67,1483,75
Tuolumne,2/12/2021,640,9429,17,623,0,203,5612,436,1919,204
Tuolumne,2/13/2021,146,9575,42,104,0,115,5702,25,1944,115
Tuolumne,2/14/2021,148,9723,12,136,0,147,5848,1,1945,147
Tuolumne,2/15/2021,184,9907,10,174,0,175,6014,9,1954,175
Tuolumne,2/16/2021,525,10432,17,508,0,123,5739,400,2354,125
Tuolumne,2/17/2021,107,10539,62,45,0,62,5757,44,2398,62
Tuolumne,2/18/2021,675,11214,26,649,0,627,6336,48,2446,627
Tuolumne,2/19/2021,131,11345,21,110,0,43,6291,88,2534,43
Tuolumne,2/20/2021,904,12249,342,562,0,386,6172,506,3040,387
Tuolumne,2/21/2021,974,13223,35,939,0,471,6143,500,3540,471
Tuolumne,2/22/2021,77,13300,56,21,0,46,6159,30,3570,46
Tuolumne,2/23/2021,46,13346,23,23,0,25,6164,20,3590,25
Tuolumne,2/24/2021,102,13448,58,44,0,43,6149,58,3648,43
Tuolumne,2/25/2021,1053,14501,34,1019,0,1022,7140,31,3679,1022
Tuolumne,2/26/2021,142,14643,10,132,0,121,7240,21,3700,121
Tuolumne,2/27/2021,947,15590,575,372,0,247,6803,684,4384,247
Tuolumne,2/28/2021,55,15645,4,51,0,52,6853,2,4386,52
Tuolumne,3/1/2021,110,15755,21,89,0,75,6896,33,4419,76
Tuolumne,3/2/2021,705,16460,73,632,0,106,6404,598,5017,106
Tuolumne,3/3/2021,88,16548,20,68,0,64,6444,24,5041,64
Tuolumne,3/4/2021,1166,17714,73,1093,0,1103,7484,63,5104,1103
Tuolumne,3/5/2021,84,17798,10,74,0,48,7498,35,5139,49
Tuolumne,3/6/2021,1051,18849,604,445,2,204,6858,846,5985,206
Tuolumne,3/7/2021,40,18889,12,14,14,18,6868,22,6007,32
Tuolumne,3/8/2021,196,19085,88,101,7,140,6959,56,6063,147
Tuolumne,3/9/2021,852,19937,15,826,11,66,6253,784,6847,78
Tuolumne,3/10/2021,74,20011,12,51,11,51,6292,23,6870,62
Tuolumne,3/11/2021,1271,21282,34,1232,5,1248,7524,23,6893,1255
Tuolumne,3/12/2021,295,21577,31,249,15,189,7627,104,6997,207
Tuolumne,3/13/2021,112,21689,12,100,0,93,7702,19,7016,94
Tuolumne,3/14/2021,142,21831,8,125,9,8,7590,134,7150,22
Tuolumne,3/15/2021,292,22123,79,211,2,101,7509,191,7341,110
Tuolumne,3/16/2021,804,22927,38,755,11,667,8050,137,7478,678
Tuolumne,3/17/2021,152,23079,31,108,13,79,8069,73,7551,92
Tuolumne,3/18/2021,946,24025,28,905,13,320,7777,626,8177,334
Tuolumne,3/19/2021,131,24156,16,83,32,70,7819,59,8236,101
Tuolumne,3/20/2021,89,24245,6,73,10,37,7814,51,8287,46
Tuolumne,3/21/2021,833,25078,390,434,9,40,7072,791,9078,49
Tuolumne,3/22/2021,163,25241,72,72,19,97,7122,66,9144,116
Tuolumne,3/23/2021,704,25945,636,54,14,668,7767,36,9180,681
Tuolumne,3/24/2021,107,26052,19,70,18,75,7829,31,9211,93
Tuolumne,3/25/2021,1291,27343,21,1267,3,322,7186,968,10179,325
Tuolumne,3/26/2021,266,27609,13,230,23,108,7170,147,10326,131
Tuolumne,3/27/2021,577,28186,54,523,0,316,7226,261,10587,317
Tuolumne,3/28/2021,51,28237,8,43,0,11,7200,38,10625,12
Tuolumne,3/29/2021,200,28437,81,119,0,105,7212,93,10718,105
Tuolumne,3/30/2021,161,28598,13,147,1,118,7289,42,10760,119
Tuolumne,3/31/2021,90,28688,13,75,2,34,7272,55,10815,38
Tuolumne,4/1/2021,1228,29916,27,1201,0,213,6473,1013,11828,214
Tuolumne,4/2/2021,163,30079,12,125,26,90,6517,72,11900,116
Tuolumne,4/3/2021,414,30493,33,380,1,229,6564,185,12085,232
Tuolumne,4/4/2021,33,30526,2,31,0,21,6575,10,12095,21
Tuolumne,4/5/2021,128,30654,20,102,6,56,6565,72,12167,62
Tuolumne,4/6/2021,634,31288,507,100,27,503,6965,131,12298,531
Tuolumne,4/7/2021,121,31409,37,68,16,43,6946,78,12376,59
Tuolumne,4/8/2021,1414,32823,30,1370,14,233,6014,1179,13555,247
Tuolumne,4/9/2021,267,33090,41,182,44,128,6051,136,13691,173
Tuolumne,4/10/2021,56,33146,3,31,22,23,6064,32,13723,45
Tuolumne,4/11/2021,16,33162,2,11,3,11,6073,5,13728,14
Tuolumne,4/12/2021,160,33322,67,87,6,87,6099,67,13795,93
Tuolumne,4/13/2021,782,34104,35,747,0,167,5658,608,14403,167
Tuolumne,4/14/2021,131,34235,26,105,0,62,5655,66,14469,63
Tuolumne,4/15/2021,333,34568,22,311,0,55,5437,273,14742,55
Tuolumne,4/16/2021,230,34798,48,182,0,132,5477,92,14834,132
Tuolumne,4/17/2021,45,34843,7,38,0,29,5490,16,14850,29
Tuolumne,4/18/2021,7,34850,2,5,0,3,5489,4,14854,3
Tuolumne,4/19/2021,161,35011,76,85,0,89,5509,69,14923,89
Tuolumne,4/20/2021,698,35709,610,88,0,77,4971,615,15538,77
Tuolumne,4/21/2021,104,35813,25,79,0,60,4992,39,15577,60
Tuolumne,4/22/2021,630,36443,45,585,0,404,5180,216,15793,404
Tuolumne,4/23/2021,80,36523,22,58,0,45,5190,35,15828,45
Ventura,12/15/2020,5,5,5,0,0,5,5,0,0,5
Ventura,12/16/2020,72,77,72,0,0,72,77,0,0,72
Ventura,12/17/2020,250,327,250,0,0,250,327,0,0,250
Ventura,12/18/2020,1410,1737,1410,0,0,1410,1737,0,0,1410
Ventura,12/19/2020,910,2647,910,0,0,910,2647,0,0,910
Ventura,12/20/2020,429,3076,429,0,0,429,3076,0,0,429
Ventura,12/21/2020,1470,4546,1470,0,0,1470,4546,0,0,1470
Ventura,12/22/2020,1103,5649,1098,5,0,1103,5649,0,0,1103
Ventura,12/23/2020,1026,6675,979,47,0,1026,6675,0,0,1026
Ventura,12/24/2020,477,7152,379,98,0,477,7152,0,0,477
Ventura,12/25/2020,11,7163,7,4,0,11,7163,0,0,11
Ventura,12/26/2020,111,7274,90,21,0,111,7274,0,0,111
Ventura,12/27/2020,58,7332,27,31,0,58,7332,0,0,58
Ventura,12/28/2020,1068,8400,929,139,0,1068,8400,0,0,1068
Ventura,12/29/2020,1167,9567,762,405,0,1167,9567,0,0,1167
Ventura,12/30/2020,1983,11550,1518,465,0,1983,11550,0,0,1983
Ventura,12/31/2020,479,12029,162,317,0,479,12029,0,0,479
Ventura,1/1/2021,20,12049,5,15,0,20,12049,0,0,20
Ventura,1/2/2021,172,12221,79,93,0,172,12221,0,0,172
Ventura,1/3/2021,15,12236,8,7,0,15,12236,0,0,15
Ventura,1/4/2021,1080,13316,549,531,0,1079,13315,0,0,1079
Ventura,1/5/2021,1371,14687,775,596,0,1331,14606,40,40,1331
Ventura,1/6/2021,2056,16743,1179,877,0,1625,15811,422,462,1627
Ventura,1/7/2021,2068,18811,1327,741,0,1181,16107,885,1347,1181
Ventura,1/8/2021,2198,21009,1476,722,0,905,15722,1291,2638,906
Ventura,1/9/2021,721,21730,500,221,0,319,15639,402,3040,319
Ventura,1/10/2021,340,22070,326,14,0,126,15551,214,3254,126
Ventura,1/11/2021,2445,24515,1488,957,0,1492,16093,953,4207,1495
Ventura,1/12/2021,3035,27550,1605,1430,0,2013,17084,1022,5229,2013
Ventura,1/13/2021,2924,30474,1423,1501,0,2041,18246,880,6109,2042
Ventura,1/14/2021,2728,33202,1058,1670,0,2283,20086,444,6553,2284
Ventura,1/15/2021,2886,36088,969,1917,0,2674,22549,212,6765,2675
Ventura,1/16/2021,483,36571,186,297,0,403,22872,80,6845,403
Ventura,1/17/2021,260,36831,137,123,0,254,23120,6,6851,254
Ventura,1/18/2021,2218,39049,1672,546,0,1668,24240,549,7400,1669
Ventura,1/19/2021,3032,42081,2115,917,0,2141,25492,891,8291,2143
Ventura,1/20/2021,4059,46140,3108,951,0,3023,27483,1033,9324,3024
Ventura,1/21/2021,3836,49976,2670,1166,0,3166,29983,667,9991,3167
Ventura,1/22/2021,3608,53584,2490,1118,0,3447,33269,161,10152,3447
Ventura,1/23/2021,1184,54768,650,534,0,1083,34254,100,10252,1085
Ventura,1/24/2021,451,55219,137,314,0,438,34679,13,10265,438
Ventura,1/25/2021,3148,58367,2028,1120,0,2598,36729,549,10814,2599
Ventura,1/26/2021,3707,62074,2201,1506,0,2711,38446,995,11809,2712
Ventura,1/27/2021,3454,65528,1556,1898,0,2716,40427,735,12544,2716
Ventura,1/28/2021,3852,69380,1978,1874,0,3239,43071,596,13140,3240
Ventura,1/29/2021,4258,73638,2519,1739,0,3759,46345,487,13627,3761
Ventura,1/30/2021,3025,76663,1955,1070,0,2856,49036,166,13793,2857
Ventura,1/31/2021,831,77494,444,387,0,746,49697,85,13878,746
Ventura,2/1/2021,3935,81429,2107,1828,0,3166,52098,766,14644,3167
Ventura,2/2/2021,4398,85827,2370,2028,0,3377,54459,1017,15661,3378
Ventura,2/3/2021,4452,90279,2089,2363,0,3441,56895,1006,16667,3442
Ventura,2/4/2021,4768,95047,2285,2483,0,3517,59170,1244,17911,3519
Ventura,2/5/2021,4827,99874,2310,2517,0,3337,61032,1477,19388,3339
Ventura,2/6/2021,2832,102706,1513,1319,0,2430,63061,401,19789,2430
Ventura,2/7/2021,709,103415,240,469,0,584,63521,125,19914,585
Ventura,2/8/2021,3495,106910,1622,1873,0,2425,64881,1065,20979,2425
Ventura,2/9/2021,4716,111626,1973,2743,0,2467,65102,2248,23227,2469
Ventura,2/10/2021,4710,116336,2235,2475,0,2403,65210,2296,25523,2404
Ventura,2/11/2021,4655,120991,1861,2794,0,2444,65453,2204,27727,2447
Ventura,2/12/2021,6297,127288,2657,3640,0,3220,65598,3075,30802,3220
Ventura,2/13/2021,3293,130581,1826,1467,0,1842,65995,1447,32249,1844
Ventura,2/14/2021,1226,131807,124,1102,0,1010,66790,216,32465,1011
Ventura,2/15/2021,3985,135792,1795,2190,0,2115,67038,1867,34332,2115
Ventura,2/16/2021,5530,141322,2700,2830,0,3007,67529,2516,36848,3007
Ventura,2/17/2021,5229,146551,1919,3310,0,3263,68835,1957,38805,3263
Ventura,2/18/2021,5775,152326,1829,3946,0,3635,70339,2131,40936,3635
Ventura,2/19/2021,6448,158774,3768,2680,0,3010,69920,3431,44367,3012
Ventura,2/20/2021,4925,163699,3161,1764,0,2770,70540,2151,46518,2771
Ventura,2/21/2021,1042,164741,754,288,0,428,70359,609,47127,428
Ventura,2/22/2021,5362,170103,2407,2955,0,3448,71902,1905,49032,3448
Ventura,2/23/2021,5923,176026,2963,2960,0,3414,72825,2493,51525,3416
Ventura,2/24/2021,6993,183019,2607,4386,0,4246,74340,2733,54258,4248
Ventura,2/25/2021,7483,190502,2571,4912,0,4572,76017,2897,57155,4574
Ventura,2/26/2021,9330,199832,2760,6570,0,6159,79031,3147,60302,6161
Ventura,2/27/2021,9984,209816,5267,4717,0,7366,83802,2603,62905,7374
Ventura,2/28/2021,2562,212378,1630,931,1,2096,85438,460,63365,2096
Ventura,3/1/2021,6932,219310,2805,4127,0,4619,87766,2304,65669,4632
Ventura,3/2/2021,7465,226775,3932,3532,1,5247,90803,2210,67879,5247
Ventura,3/3/2021,8502,235277,3890,4612,0,6064,94446,2425,70304,6068
Ventura,3/4/2021,8049,243326,3863,4186,0,5429,97269,2607,72911,5430
Ventura,3/5/2021,9962,253288,4797,5155,10,7078,101494,2871,75782,7096
Ventura,3/6/2021,7232,260520,4396,2683,153,5323,105069,1903,77685,5478
Ventura,3/7/2021,1650,262170,601,948,101,1234,105988,416,78101,1335
Ventura,3/8/2021,6735,268905,3414,3168,153,4632,108679,2097,80198,4788
Ventura,3/9/2021,6517,275422,2804,3516,197,3656,109684,2850,83048,3855
Ventura,3/10/2021,6791,282213,2964,3589,238,4478,112095,2305,85353,4716
Ventura,3/11/2021,6269,288482,2883,3167,219,3413,112881,2845,88198,3631
Ventura,3/12/2021,8486,296968,3030,4614,842,4085,113424,4385,92583,4928
Ventura,3/13/2021,6674,303642,2493,3341,840,3752,115099,2916,95499,4591
Ventura,3/14/2021,2129,305771,476,1158,495,728,114924,1400,96899,1225
Ventura,3/15/2021,6906,312677,2046,3510,1350,2967,115325,3916,100815,4317
Ventura,3/16/2021,7879,320556,2451,4316,1112,3967,116501,3900,104715,5076
Ventura,3/17/2021,7437,327993,2758,4333,346,4447,118325,2971,107686,4795
Ventura,3/18/2021,7207,335200,3265,3789,153,4696,120673,2499,110185,4847
Ventura,3/19/2021,8314,343514,3764,4440,110,4947,122377,3351,113536,5055
Ventura,3/20/2021,8130,351644,5237,2873,20,3886,122059,4225,117761,3907
Ventura,3/21/2021,2771,354415,1507,893,371,1312,122292,1449,119210,1682
Ventura,3/22/2021,7326,361741,3683,3541,102,4840,124764,2472,121682,4944
Ventura,3/23/2021,8167,369908,3872,4224,71,4660,126011,3483,125165,4730
Ventura,3/24/2021,8837,378745,3406,5357,74,4411,126097,4399,129564,4485
Ventura,3/25/2021,8769,387514,3904,4765,100,4435,126314,4318,133882,4535
Ventura,3/26/2021,9665,397179,3335,5677,653,3761,124850,5877,139759,4413
Ventura,3/27/2021,8101,405280,3899,4162,40,2393,121594,5690,145449,2434
Ventura,3/28/2021,2510,407790,1396,1105,9,1376,121848,1131,146580,1385
Ventura,3/29/2021,8445,416235,4260,4141,44,4218,121910,4200,150780,4262
Ventura,3/30/2021,8907,425142,4391,4392,124,4533,122203,4362,155142,4655
Ventura,3/31/2021,10634,435776,4804,5203,627,4616,121446,5998,161140,5241
Ventura,4/1/2021,10598,446374,5176,4556,866,5375,122476,5207,166347,6237
Ventura,4/2/2021,11363,457737,4570,5546,1247,5357,123102,5982,172329,6608
Ventura,4/3/2021,8001,465738,3942,2927,1132,3361,122963,4630,176959,4491
Ventura,4/4/2021,1710,467448,962,619,129,1155,123697,550,177509,1284
Ventura,4/5/2021,9201,476649,4861,3285,1055,4681,124919,4513,182022,5735
Ventura,4/6/2021,10793,487442,5539,3794,1460,5545,126695,5227,187249,7003
Ventura,4/7/2021,11221,498663,5423,4329,1469,5116,127184,6090,193339,6579
Ventura,4/8/2021,10191,508854,5287,3979,925,5099,128125,5076,198415,6017
Ventura,4/9/2021,10983,519837,4329,4967,1687,4822,128488,6141,204556,6504
Ventura,4/10/2021,9101,528938,3479,3474,2148,2990,127526,6096,210652,5134
Ventura,4/11/2021,2410,531348,862,992,556,685,127048,1718,212370,1240
Ventura,4/12/2021,8869,540217,4463,3611,795,3736,126459,5115,217485,4526
Ventura,4/13/2021,8723,548940,4436,4282,5,3735,125248,4951,222436,3740
Ventura,4/14/2021,8635,557575,4050,4570,15,3373,123411,5227,227663,3390
Ventura,4/15/2021,9217,566792,4468,4742,7,4048,122316,5150,232813,4055
Ventura,4/16/2021,9937,576729,4374,5563,0,4787,121964,5140,237953,4788
Ventura,4/17/2021,8512,585241,5288,3223,1,4987,123437,3516,241469,4989
Ventura,4/18/2021,2088,587329,1009,1079,0,903,123160,1180,242649,903
Ventura,4/19/2021,7971,595300,4822,3148,1,4610,124426,3345,245994,4611
Ventura,4/20/2021,9121,604421,4889,4232,0,4304,123930,4802,250796,4306
Ventura,4/21/2021,8623,613044,4517,4104,2,4097,123522,4508,255304,4100
Ventura,4/22/2021,8838,621882,5225,3613,0,3956,122610,4868,260172,3956
Ventura,4/23/2021,5851,627733,3266,2585,0,3593,123956,2247,262419,3593
Yolo,12/15/2020,39,39,39,0,0,39,39,0,0,39
Yolo,12/16/2020,78,117,78,0,0,78,117,0,0,78
Yolo,12/17/2020,102,219,102,0,0,102,219,0,0,102
Yolo,12/18/2020,210,429,210,0,0,210,429,0,0,210
Yolo,12/19/2020,87,516,87,0,0,87,516,0,0,87
Yolo,12/20/2020,101,617,101,0,0,101,617,0,0,101
Yolo,12/21/2020,253,870,253,0,0,253,870,0,0,253
Yolo,12/22/2020,382,1252,381,1,0,382,1252,0,0,382
Yolo,12/23/2020,430,1682,412,18,0,430,1682,0,0,430
Yolo,12/24/2020,150,1832,94,56,0,150,1832,0,0,150
Yolo,12/25/2020,1,1833,1,0,0,1,1833,0,0,1
Yolo,12/26/2020,75,1908,25,50,0,75,1908,0,0,75
Yolo,12/27/2020,46,1954,19,27,0,46,1954,0,0,46
Yolo,12/28/2020,345,2299,178,167,0,345,2299,0,0,345
Yolo,12/29/2020,487,2786,268,219,0,487,2786,0,0,487
Yolo,12/30/2020,622,3408,255,367,0,622,3408,0,0,622
Yolo,12/31/2020,184,3592,95,89,0,184,3592,0,0,184
Yolo,1/1/2021,57,3649,56,1,0,57,3649,0,0,57
Yolo,1/2/2021,68,3717,25,43,0,68,3717,0,0,68
Yolo,1/3/2021,44,3761,19,25,0,44,3761,0,0,44
Yolo,1/4/2021,193,3954,43,150,0,193,3954,0,0,193
Yolo,1/5/2021,609,4563,235,374,0,548,4441,61,61,548
Yolo,1/6/2021,481,5044,183,298,0,350,4660,131,192,350
Yolo,1/7/2021,710,5754,234,476,0,520,4991,189,381,520
Yolo,1/8/2021,631,6385,311,320,0,414,5189,216,597,414
Yolo,1/9/2021,410,6795,68,342,0,364,5507,46,643,364
Yolo,1/10/2021,393,7188,80,313,0,323,5760,70,713,323
Yolo,1/11/2021,559,7747,322,237,0,292,5785,267,980,292
Yolo,1/12/2021,481,8228,364,117,0,173,5651,308,1288,174
Yolo,1/13/2021,767,8995,310,457,0,518,5920,249,1537,518
Yolo,1/14/2021,374,9369,181,193,0,270,6086,104,1641,270
Yolo,1/15/2021,624,9993,321,303,0,545,6553,79,1720,546
Yolo,1/16/2021,738,10731,95,643,0,707,7229,31,1751,707
Yolo,1/17/2021,186,10917,117,69,0,179,7401,7,1758,179
Yolo,1/18/2021,478,11395,303,175,0,380,7683,98,1856,380
Yolo,1/19/2021,541,11936,372,169,0,366,7874,175,2031,366
Yolo,1/20/2021,659,12595,381,278,0,474,8164,184,2215,474
Yolo,1/21/2021,646,13241,382,264,0,458,8434,188,2403,458
Yolo,1/22/2021,745,13986,250,495,0,628,8947,115,2518,628
Yolo,1/23/2021,613,14599,124,489,0,566,9466,47,2565,566
Yolo,1/24/2021,207,14806,124,83,0,166,9591,41,2606,166
Yolo,1/25/2021,727,15533,153,574,0,513,9890,214,2820,513
Yolo,1/26/2021,817,16350,326,491,0,429,9931,388,3208,429
Yolo,1/27/2021,554,16904,223,331,0,381,10139,173,3381,381
Yolo,1/28/2021,1045,17949,563,482,0,922,10939,122,3503,922
Yolo,1/29/2021,867,18816,263,604,0,785,11643,81,3584,785
Yolo,1/30/2021,1516,20332,916,600,0,1408,12949,102,3686,1408
Yolo,1/31/2021,249,20581,211,38,0,214,13129,34,3720,214
Yolo,2/1/2021,842,21423,359,483,0,612,13514,227,3947,612
Yolo,2/2/2021,1319,22742,745,574,0,929,14054,390,4337,930
Yolo,2/3/2021,1513,24255,396,1117,0,1183,14910,327,4664,1183
Yolo,2/4/2021,1786,26041,281,1505,0,1237,15610,538,5202,1238
Yolo,2/5/2021,1591,27632,898,693,0,1193,16406,398,5600,1194
Yolo,2/6/2021,1919,29551,1246,673,0,1558,17604,361,5961,1559
Yolo,2/7/2021,517,30068,248,269,0,170,17428,346,6307,170
Yolo,2/8/2021,945,31013,331,614,0,603,17692,339,6646,603
Yolo,2/9/2021,856,31869,384,472,0,574,17984,282,6928,574
Yolo,2/10/2021,1454,33323,476,978,0,818,18169,635,7563,820
Yolo,2/11/2021,1539,34862,775,764,0,1162,18954,377,7940,1162
Yolo,2/12/2021,1904,36766,746,1158,0,1438,19930,462,8402,1438
Yolo,2/13/2021,2047,38813,709,1338,0,1384,20651,663,9065,1384
Yolo,2/14/2021,567,39380,152,415,0,442,20969,124,9189,442
Yolo,2/15/2021,528,39908,189,339,0,265,20972,263,9452,266
Yolo,2/16/2021,1114,41022,424,690,0,807,21472,307,9759,807
Yolo,2/17/2021,1381,42403,698,683,0,990,22071,391,10150,990
Yolo,2/18/2021,2439,44842,758,1681,0,1676,22984,763,10913,1676
Yolo,2/19/2021,1735,46577,742,993,0,1118,23487,615,11528,1118
Yolo,2/20/2021,2432,49009,942,1490,0,1360,23781,1067,12595,1361
Yolo,2/21/2021,282,49291,225,57,0,73,23646,208,12803,73
Yolo,2/22/2021,1359,50650,599,760,0,692,23672,666,13469,692
Yolo,2/23/2021,1120,51770,840,280,0,439,23432,679,14148,439
Yolo,2/24/2021,2089,53859,589,1500,0,1381,24107,706,14854,1381
Yolo,2/25/2021,1338,55197,444,894,0,873,24516,464,15318,873
Yolo,2/26/2021,2563,57760,983,1580,0,1366,24688,1194,16512,1366
Yolo,2/27/2021,1647,59407,765,882,0,1197,25435,450,16962,1197
Yolo,2/28/2021,1772,61179,1489,283,0,680,25025,1090,18052,680
Yolo,3/1/2021,1088,62267,354,734,0,658,25255,428,18480,658
Yolo,3/2/2021,1457,63724,678,779,0,928,25654,529,19009,928
Yolo,3/3/2021,1816,65540,611,1205,0,812,25464,1002,20011,812
Yolo,3/4/2021,2844,68384,1403,1441,0,1539,25700,1303,21314,1539
Yolo,3/5/2021,2336,70720,1392,933,11,1467,26310,868,22182,1478
Yolo,3/6/2021,1471,72191,1121,321,29,839,26549,629,22811,868
Yolo,3/7/2021,903,73094,670,219,14,770,27200,133,22944,784
Yolo,3/8/2021,1074,74168,480,551,43,749,27668,325,23269,793
Yolo,3/9/2021,1243,75411,669,514,60,755,27997,486,23755,815
Yolo,3/10/2021,1783,77194,1040,452,291,743,27987,1039,24794,1029
Yolo,3/11/2021,2278,79472,1534,677,67,1567,28912,710,25504,1635
Yolo,3/12/2021,2885,82357,1339,1467,79,1370,28851,1509,27013,1448
Yolo,3/13/2021,1840,84197,729,934,177,1006,29204,830,27843,1183
Yolo,3/14/2021,1007,85204,213,644,150,525,29395,481,28324,672
Yolo,3/15/2021,1318,86522,773,369,176,701,29656,615,28939,876
Yolo,3/16/2021,1864,88386,714,1078,72,1101,30066,763,29702,1173
Yolo,3/17/2021,2480,90866,965,1443,72,1700,31092,777,30479,1803
Yolo,3/18/2021,2882,93748,895,1764,223,1172,30779,1708,32187,1395
Yolo,3/19/2021,2037,95785,816,1154,67,1074,30963,957,33144,1141
Yolo,3/20/2021,2744,98529,815,1888,41,1114,30496,1624,34768,1157
Yolo,3/21/2021,317,98846,216,93,8,229,30647,86,34854,237
Yolo,3/22/2021,1382,100228,482,848,52,909,31136,471,35325,960
Yolo,3/23/2021,1724,101952,931,737,56,1065,31599,658,35983,1121
Yolo,3/24/2021,2838,104790,1385,1404,49,1419,31658,1409,37392,1468
Yolo,3/25/2021,2417,107207,1296,1094,27,1155,31588,1252,38644,1182
Yolo,3/26/2021,2381,109588,1238,1124,19,1023,31278,1351,39995,1041
Yolo,3/27/2021,1635,111223,455,1164,16,755,31170,879,40874,771
Yolo,3/28/2021,1102,112325,860,224,18,272,30634,826,41700,290
Yolo,3/29/2021,1994,114319,819,1157,18,986,30634,1004,42704,1004
Yolo,3/30/2021,2269,116588,1066,1180,23,1188,30769,1076,43780,1211
Yolo,3/31/2021,2330,118918,1205,1089,36,1204,30884,1125,44905,1240
Yolo,4/1/2021,3744,122662,1764,1505,475,1567,30752,2174,47079,2042
Yolo,4/2/2021,3107,125769,1480,1567,60,2028,31767,1073,48152,2088
Yolo,4/3/2021,1787,127556,1079,493,215,800,31796,986,49138,1015
Yolo,4/4/2021,385,127941,151,171,63,143,31760,242,49380,206
Yolo,4/5/2021,1893,129834,721,1074,98,1011,31991,878,50258,1109
Yolo,4/6/2021,2555,132389,1294,1091,170,1309,32234,1237,51495,1480
Yolo,4/7/2021,2865,135254,1512,1104,249,1925,33474,933,52428,2173
Yolo,4/8/2021,2403,137657,992,941,470,1022,33586,1378,53806,1490
Yolo,4/9/2021,2424,140081,877,1053,494,803,33264,1618,55424,1296
Yolo,4/10/2021,1680,141761,790,719,171,997,33752,679,56103,1167
Yolo,4/11/2021,866,142627,261,560,45,344,33621,519,56622,388
Yolo,4/12/2021,1752,144379,515,1095,142,1091,34196,658,57280,1233
Yolo,4/13/2021,1931,146310,873,1058,0,1001,34269,928,58208,1001
Yolo,4/14/2021,2723,149033,734,1989,0,1349,34249,1369,59577,1349
Yolo,4/15/2021,3194,152227,1041,2153,0,2246,35551,944,60521,2246
Yolo,4/16/2021,2893,155120,1836,1057,0,1829,36320,1060,61581,1829
Yolo,4/17/2021,1506,156626,414,1092,0,743,36305,758,62339,743
Yolo,4/18/2021,591,157217,263,328,0,349,36415,239,62578,349
Yolo,4/19/2021,1658,158875,718,939,1,768,36299,885,63463,769
Yolo,4/20/2021,1988,160863,1004,984,0,1072,36457,914,64377,1072
Yolo,4/21/2021,1952,162815,977,975,0,1070,36648,879,65256,1070
Yolo,4/22/2021,1577,164392,670,907,0,824,36725,748,66004,825
Yolo,4/23/2021,1216,165608,566,650,0,773,37062,437,66441,774
Yuba,12/16/2020,4,4,4,0,0,4,4,0,0,4
Yuba,12/17/2020,4,8,4,0,0,4,8,0,0,4
Yuba,12/18/2020,8,16,8,0,0,8,16,0,0,8
Yuba,12/19/2020,12,28,12,0,0,12,28,0,0,12
Yuba,12/20/2020,20,48,20,0,0,20,48,0,0,20
Yuba,12/21/2020,40,88,40,0,0,40,88,0,0,40
Yuba,12/22/2020,86,174,86,0,0,86,174,0,0,86
Yuba,12/23/2020,63,237,61,2,0,63,237,0,0,63
Yuba,12/24/2020,20,257,10,10,0,20,257,0,0,20
Yuba,12/26/2020,15,272,13,2,0,15,272,0,0,15
Yuba,12/27/2020,15,287,15,0,0,15,287,0,0,15
Yuba,12/28/2020,51,338,35,16,0,51,338,0,0,51
Yuba,12/29/2020,75,413,10,65,0,75,413,0,0,75
Yuba,12/30/2020,63,476,20,43,0,63,476,0,0,63
Yuba,12/31/2020,36,512,6,30,0,36,512,0,0,36
Yuba,1/2/2021,23,535,22,1,0,23,535,0,0,23
Yuba,1/3/2021,10,545,6,4,0,10,545,0,0,10
Yuba,1/4/2021,90,635,21,69,0,90,635,0,0,90
Yuba,1/5/2021,68,703,36,32,0,67,701,1,1,67
Yuba,1/6/2021,153,856,76,77,0,147,842,6,7,147
Yuba,1/7/2021,75,931,19,56,0,72,910,4,11,72
Yuba,1/8/2021,73,1004,25,48,0,66,969,7,18,66
Yuba,1/9/2021,19,1023,16,3,0,11,972,8,26,11
Yuba,1/10/2021,117,1140,22,95,0,95,1045,22,48,95
Yuba,1/11/2021,72,1212,50,22,0,32,1037,40,88,32
Yuba,1/12/2021,107,1319,77,30,0,42,1014,65,153,42
Yuba,1/13/2021,118,1437,71,47,0,54,1005,63,216,54
Yuba,1/14/2021,109,1546,43,66,0,97,1090,12,228,97
Yuba,1/15/2021,206,1752,88,118,0,195,1274,11,239,195
Yuba,1/16/2021,184,1936,21,163,0,172,1433,13,252,172
Yuba,1/17/2021,13,1949,9,4,0,7,1434,6,258,7
Yuba,1/18/2021,60,2009,32,28,0,35,1444,25,283,35
Yuba,1/19/2021,80,2089,29,51,0,65,1494,15,298,65
Yuba,1/20/2021,132,2221,87,45,0,109,1580,23,321,109
Yuba,1/21/2021,210,2431,95,115,0,202,1774,8,329,202
Yuba,1/22/2021,103,2534,6,97,0,94,1859,9,338,94
Yuba,1/23/2021,200,2734,7,193,0,197,2053,3,341,197
Yuba,1/24/2021,10,2744,7,3,0,8,2059,2,343,8
Yuba,1/25/2021,83,2827,27,56,0,52,2081,30,373,52
Yuba,1/26/2021,148,2975,39,109,0,92,2117,56,429,92
Yuba,1/27/2021,182,3157,128,54,0,115,2165,67,496,115
Yuba,1/28/2021,215,3372,79,136,0,174,2298,41,537,174
Yuba,1/29/2021,159,3531,56,103,0,112,2363,47,584,112
Yuba,1/30/2021,410,3941,23,387,0,399,2751,11,595,399
Yuba,1/31/2021,17,3958,12,5,0,15,2764,2,597,15
Yuba,2/1/2021,155,4113,75,80,0,131,2873,23,620,132
Yuba,2/2/2021,123,4236,23,100,0,101,2952,22,642,101
Yuba,2/3/2021,225,4461,29,196,0,113,2954,111,753,113
Yuba,2/4/2021,295,4756,120,175,0,252,3163,43,796,252
Yuba,2/5/2021,146,4902,32,114,0,70,3157,76,872,70
Yuba,2/6/2021,448,5350,26,422,0,440,3589,8,880,440
Yuba,2/7/2021,18,5368,11,7,0,15,3601,3,883,15
Yuba,2/8/2021,95,5463,35,60,0,66,3638,29,912,66
Yuba,2/9/2021,153,5616,55,98,0,84,3653,69,981,84
Yuba,2/10/2021,352,5968,172,180,0,114,3530,237,1218,114
Yuba,2/11/2021,397,6365,63,334,0,301,3737,94,1312,301
Yuba,2/12/2021,264,6629,27,237,0,151,3775,113,1425,151
Yuba,2/13/2021,435,7064,35,400,0,387,4114,48,1473,387
Yuba,2/14/2021,54,7118,11,43,0,49,4158,5,1478,49
Yuba,2/15/2021,88,7206,36,52,0,69,4208,19,1497,69
Yuba,2/16/2021,198,7404,53,145,0,140,4291,57,1554,140
Yuba,2/17/2021,369,7773,155,214,0,98,4119,270,1824,98
Yuba,2/18/2021,304,8077,33,271,0,181,4177,123,1947,181
Yuba,2/19/2021,224,8301,84,140,0,141,4235,83,2030,141
Yuba,2/20/2021,390,8691,30,360,0,336,4517,54,2084,336
Yuba,2/21/2021,16,8707,14,2,0,6,4513,10,2094,6
Yuba,2/22/2021,128,8835,79,49,0,38,4462,89,2183,38
Yuba,2/23/2021,113,8948,25,88,0,46,4442,66,2249,46
Yuba,2/24/2021,479,9427,135,344,0,106,4175,373,2622,106
Yuba,2/25/2021,332,9759,133,199,0,204,4251,128,2750,204
Yuba,2/26/2021,256,10015,67,189,0,143,4283,111,2861,143
Yuba,2/27/2021,471,10486,46,425,0,382,4578,87,2948,382
Yuba,2/28/2021,65,10551,21,44,0,44,4601,21,2969,44
Yuba,3/1/2021,152,10703,39,113,0,76,4602,75,3044,76
Yuba,3/2/2021,158,10861,35,123,0,78,4600,80,3124,78
Yuba,3/3/2021,618,11479,157,461,0,198,4379,419,3543,198
Yuba,3/4/2021,465,11944,270,195,0,324,4563,140,3683,324
Yuba,3/5/2021,315,12259,59,255,1,248,4745,67,3750,249
Yuba,3/6/2021,475,12734,35,436,4,369,5012,106,3856,373
Yuba,3/7/2021,49,12783,27,21,1,33,5030,16,3872,34
Yuba,3/8/2021,160,12943,49,95,16,101,5088,59,3931,117
Yuba,3/9/2021,175,13118,46,110,19,83,5098,92,4023,102
Yuba,3/10/2021,733,13851,232,471,30,229,4854,503,4526,259
Yuba,3/11/2021,428,14279,186,230,12,295,5028,133,4659,307
Yuba,3/12/2021,462,14741,86,322,54,149,4918,313,4972,203
Yuba,3/13/2021,451,15192,331,105,15,357,5197,93,5065,372
Yuba,3/14/2021,107,15299,21,76,10,46,5193,60,5125,56
Yuba,3/15/2021,194,15493,49,128,17,99,5214,95,5220,116
Yuba,3/16/2021,290,15783,71,194,25,177,5304,112,5332,202
Yuba,3/17/2021,737,16520,161,547,29,191,4980,544,5876,220
Yuba,3/18/2021,564,17084,148,303,113,342,5212,222,6098,454
Yuba,3/19/2021,325,17409,120,156,49,186,5309,138,6236,235
Yuba,3/20/2021,552,17961,80,454,18,472,5720,79,6315,490
Yuba,3/21/2021,59,18020,35,24,0,47,5755,12,6327,47
Yuba,3/22/2021,190,18210,70,113,7,148,5868,42,6369,155
Yuba,3/23/2021,263,18473,79,157,27,178,5989,84,6453,205
Yuba,3/24/2021,762,19235,251,430,81,184,5678,576,7029,265
Yuba,3/25/2021,496,19731,263,211,22,246,5696,250,7279,268
Yuba,3/26/2021,387,20118,143,217,27,221,5779,165,7444,248
Yuba,3/27/2021,461,20579,27,431,3,407,6135,53,7497,409
Yuba,3/28/2021,98,20677,40,54,4,37,6115,61,7558,41
Yuba,3/29/2021,293,20970,85,177,31,181,6215,112,7670,212
Yuba,3/30/2021,272,21242,67,197,8,191,6333,81,7751,199
Yuba,3/31/2021,671,21913,113,546,12,246,6167,424,8175,258
Yuba,4/1/2021,615,22528,283,303,29,283,6147,332,8507,312
Yuba,4/2/2021,484,23012,90,312,82,181,6107,302,8809,262
Yuba,4/3/2021,653,23665,56,115,482,87,6111,565,9374,569
Yuba,4/4/2021,58,23723,11,41,6,33,6125,25,9399,39
Yuba,4/5/2021,245,23968,79,147,19,124,6148,119,9518,142
Yuba,4/6/2021,337,24305,114,163,60,158,6188,178,9696,218
Yuba,4/7/2021,768,25073,397,320,51,347,6167,418,10114,397
Yuba,4/8/2021,730,25803,297,171,262,262,6224,467,10581,524
Yuba,4/9/2021,391,26194,170,157,64,159,6216,231,10812,223
Yuba,4/10/2021,592,26786,71,74,447,70,6213,520,11332,517
Yuba,4/11/2021,98,26884,22,64,12,39,6205,59,11391,51
Yuba,4/12/2021,209,27093,46,135,28,81,6187,127,11518,109
Yuba,4/13/2021,394,27487,100,294,0,202,6198,191,11709,202
Yuba,4/14/2021,690,28177,107,583,0,117,5743,572,12281,117
Yuba,4/15/2021,294,28471,123,171,0,124,5697,170,12451,124
Yuba,4/16/2021,328,28799,102,226,0,178,5725,150,12601,178
Yuba,4/17/2021,391,29190,54,337,0,320,5975,70,12671,320
Yuba,4/18/2021,51,29241,9,42,0,24,5972,27,12698,24
Yuba,4/19/2021,244,29485,102,142,0,103,5934,141,12839,103
Yuba,4/20/2021,302,29787,79,223,0,177,5987,125,12964,178
Yuba,4/21/2021,694,30481,283,411,0,299,5891,395,13359,299
Yuba,4/22/2021,269,30750,95,174,0,149,5920,120,13479,149
Yuba,4/23/2021,177,30927,27,150,0,96,5935,81,13560,96
